VILLAGE_ID,里名,DPP,KMT,PFP,NPP,GSDP,NewP,Others,Valid_All,Invalid,Votes_All,People,Vote_Rate
6301100-033,士林區三玉里,1431,942,164,232,123,253,309,3454,42,3496,5050,69.22333272
6301100-001,士林區仁勇里,1130,551,133,147,45,104,210,2320,30,2350,3420,68.77000046
6301100-044,士林區公館里,445,155,31,36,18,19,70,774,23,797,1244,64.06999969
6301100-040,士林區天山里,1535,1131,187,248,159,364,351,3975,49,4024,5933,67.98749924
6301100-042,士林區天母里,1513,1067,211,231,146,376,357,3901,54,3955,5754,68.28249931
6301100-041,士林區天玉里,1934,1366,259,301,195,479,459,4993,47,5040,7341,68.68600006
6301100-039,士林區天和里,1755,1177,207,278,163,401,391,4372,36,4408,6380,69.12249947
6301100-037,士林區天祿里,1345,789,164,189,101,166,304,3058,38,3096,4516,68.50999959
6301100-038,士林區天壽里,1167,815,139,196,104,236,227,2884,47,2931,4235,69.31333415
6301100-036,士林區天福里,1434,1001,164,235,143,311,290,3578,54,3632,5291,68.47000122
6301100-048,士林區平等里,601,129,22,41,17,20,80,910,11,921,1290,71.40000153
6301100-022,士林區永倫里,2358,861,298,268,100,139,339,4363,69,4432,6420,68.98750114
6301100-043,士林區永福里,367,176,37,41,25,2,76,724,15,739,1121,65.91999817
6301100-026,士林區名山里,1654,1208,222,290,151,358,406,4289,48,4337,6202,69.8599987
6301100-011,士林區百齡里,2061,994,229,285,137,190,420,4316,54,4370,6151,71.04249954
6301100-025,士林區岩山里,732,643,92,132,82,166,167,2014,21,2035,3027,67.27000046
6301100-030,士林區忠誠里,984,1185,166,185,96,399,312,3327,44,3371,4895,69.00666809
6301100-012,士林區承德里,1402,877,202,214,89,229,302,3315,35,3350,4898,68.36333466
6301100-014,士林區明勝里,1401,669,166,222,86,168,214,2926,37,2963,4307,68.77666728
6301100-032,士林區東山里,1042,980,170,148,99,274,267,2980,47,3027,4404,68.62666575
6301100-019,士林區社子里,2007,740,333,244,72,128,301,3825,46,3871,5530,70.02249908
6301100-021,士林區社園里,2424,765,292,261,97,125,341,4305,85,4390,6255,70.11499786
6301100-020,士林區社新里,2848,1059,349,301,116,155,406,5234,87,5321,7744,68.72999878
6301100-031,士林區芝山里,1740,1206,231,298,156,341,408,4380,70,4450,6458,68.90250206
6301100-010,士林區前港里,1262,615,200,162,77,113,233,2662,46,2708,3844,70.45999908
6301100-008,士林區後港里,2305,1139,199,336,131,205,364,4679,75,4754,7055,67.54999924
6301100-016,士林區富光里,1730,666,197,229,75,149,305,3351,59,3410,5068,67.20666885
6301100-024,士林區富洲里,2152,501,202,193,40,72,305,3465,81,3546,5003,70.8833313
6301100-047,士林區菁山里,458,234,42,49,19,48,75,925,34,959,1439,65.91499901
6301100-046,士林區陽明里,785,464,93,75,40,129,168,1754,31,1785,2745,64.96000036
6301100-045,士林區新安里,635,263,56,57,18,60,101,1190,25,1215,1774,68.49499893
6301100-049,士林區溪山里,435,164,32,36,13,26,104,810,14,824,1273,64.73000336
6301100-002,士林區義信里,742,470,86,117,50,120,184,1769,32,1801,2700,66.80000305
6301100-029,士林區聖山里,1097,937,157,164,119,312,269,3055,47,3102,4354,71.25666555
6301100-018,士林區葫東里,1295,501,141,159,63,90,178,2427,33,2460,3549,69.30500031
6301100-017,士林區葫蘆里,2181,1155,232,294,115,213,362,4552,62,4614,6558,70.36500168
6301100-009,士林區福中里,1992,826,232,281,102,202,386,4021,53,4074,5818,70.02249908
6301100-023,士林區福安里,1990,292,172,161,43,59,196,2913,50,2963,4166,71.13666789
6301100-005,士林區福志里,1742,1308,196,256,173,467,421,4563,67,4630,6581,70.42500114
6301100-007,士林區福佳里,2110,1190,222,261,133,288,484,4688,58,4746,6649,71.34749794
6301100-003,士林區福林里,710,485,109,97,60,133,180,1774,32,1806,2653,66.81333288
6301100-013,士林區福華里,1714,874,226,218,83,192,344,3651,51,3702,5588,66.08749866
6301100-015,士林區福順里,1683,609,188,185,76,116,281,3138,48,3186,4543,70.08999888
6301100-004,士林區福德里,1097,787,154,165,75,168,267,2713,47,2760,5127,59.4024992
6301100-050,士林區翠山里,347,569,75,86,87,240,181,1585,18,1603,2399,66.81000137
6301100-027,士林區德行里,1110,703,147,165,95,153,223,2596,39,2635,3803,69.25999959
6301100-028,士林區德華里,1551,839,147,186,122,197,355,3397,61,3458,4874,70.89333344
6301100-051,士林區臨溪里,671,514,113,92,61,128,168,1747,28,1775,2616,67.83499908
6301100-006,士林區舊佳里,1634,969,178,209,120,206,322,3638,58,3696,5293,69.74750137
6301100-034,士林區蘭雅里,2087,1442,273,336,192,344,450,5124,70,5194,7476,69.50200043
6301100-035,士林區蘭興里,1651,1031,209,250,158,248,330,3877,62,3939,5594,70.50500107
6300600-009,大同區大有里,1531,644,196,206,78,82,209,2946,35,2981,4201,70.97666677
6300600-013,大同區民權里,1763,895,191,234,102,172,309,3666,46,3712,5419,68.4849987
6300600-005,大同區永樂里,1568,691,157,235,102,131,258,3142,52,3194,4611,69.31000137
6300600-001,大同區玉泉里,829,427,90,120,52,86,134,1738,25,1763,2568,68.67000198
6300600-008,大同區光能里,1593,690,185,174,72,123,232,3069,30,3099,4274,72.46666463
6300600-024,大同區老師里,1953,754,172,234,85,110,273,3581,47,3628,5112,71.06500053
6300600-022,大同區至聖里,2389,1096,254,322,136,222,400,4819,73,4892,6962,70.33000031
6300600-010,大同區延平里,1133,599,156,158,76,114,195,2431,39,2470,3595,68.79333496
6300600-026,大同區保安里,1324,552,117,174,68,84,202,2521,46,2567,3596,71.39999898
6300600-012,大同區南芳里,1104,583,72,171,55,86,171,2242,60,2302,3413,67.33666738
6300600-003,大同區建功里,1316,619,144,157,56,125,222,2639,43,2682,3979,67.45333099
6300600-002,大同區建明里,978,468,101,118,57,102,175,1999,36,2035,2992,67.97500229
6300600-004,大同區建泰里,1122,485,110,145,60,88,181,2191,35,2226,3171,70.20333354
6300600-007,大同區星明里,1588,768,194,228,92,153,311,3334,62,3396,4984,68.18249893
6300600-025,大同區重慶里,1813,945,213,280,122,231,332,3936,55,3991,5629,70.79500008
6300600-017,大同區國順里,1007,338,101,101,44,63,132,1786,34,1820,2587,70.33499908
6300600-018,大同區國慶里,1320,630,117,170,83,95,232,2647,43,2690,3789,70.99666595
6300600-019,大同區揚雅里,1146,486,118,142,57,63,152,2164,42,2206,3832,59.8599987
6300600-020,大同區斯文里,1635,697,176,202,70,92,279,3151,50,3201,4706,68.37000084
6300600-014,大同區景星里,821,369,81,116,36,54,123,1600,30,1630,2451,66.44499969
6300600-006,大同區朝陽里,1300,578,154,171,70,119,215,2607,43,2650,3858,68.71666718
6300600-015,大同區隆和里,952,376,88,128,47,60,151,1802,25,1827,2611,69.95500183
6300600-016,大同區蓬萊里,1368,674,166,222,90,113,247,2880,50,2930,4257,68.80333455
6300600-021,大同區鄰江里,2138,883,193,249,85,130,320,3998,61,4059,5651,71.85499954
6300600-011,大同區雙連里,2709,1273,242,386,98,224,439,5371,73,5444,7967,68.2142868
6300300-043,大安區大學里,1586,1394,224,259,229,487,641,4820,73,4893,7080,69.1019989
6300300-005,大安區仁愛里,991,875,141,141,78,312,204,2742,28,2770,4503,61.51500034
6300300-002,大安區仁慈里,1106,801,143,165,154,322,245,2936,25,2961,4237,69.98666636
6300300-013,大安區古風里,878,712,141,124,97,219,243,2414,23,2437,3547,68.6200002
6300300-014,大安區古莊里,1385,1105,187,226,149,364,462,3878,54,3932,5864,67.06249809
6300300-052,大安區正聲里,867,805,126,161,104,341,223,2627,31,2658,4076,65.26000086
6300300-004,大安區民炤里,1712,1209,209,232,155,440,406,4363,48,4411,6700,65.82200012
6300300-007,大安區民輝里,1485,1087,223,202,166,346,353,3862,39,3901,5918,65.87750053
6300300-018,大安區永康里,705,561,132,121,71,210,196,1996,21,2017,3025,66.68000031
6300300-019,大安區光明里,712,567,94,120,77,150,170,1890,20,1910,2785,68.57999802
6300300-010,大安區光武里,1527,1176,256,210,127,481,352,4129,50,4179,6541,63.69600067
6300300-056,大安區光信里,1536,1271,242,267,142,472,383,4313,71,4384,6496,67.49600067
6300300-035,大安區全安里,834,761,121,122,111,307,188,2444,29,2473,3785,65.34666697
6300300-029,大安區住安里,975,896,165,177,107,271,260,2851,37,2888,4504,64.17000071
6300300-055,大安區車層里,1344,1001,173,154,110,360,300,3442,43,3485,5355,65.06000042
6300300-003,大安區和安里,1192,1156,191,203,143,405,355,3645,63,3708,5502,67.36500168
6300300-008,大安區昌隆里,741,491,82,110,52,169,130,1775,19,1794,2711,66.15999985
6300300-034,大安區法治里,796,795,138,148,97,319,222,2515,39,2554,3861,66.18000031
6300300-039,大安區臥龍里,303,360,58,57,42,143,125,1088,17,1105,1617,68.33999634
6300300-044,大安區芳和里,1110,1056,184,176,114,350,283,3273,54,3327,5019,66.23750114
6300300-038,大安區虎嘯里,678,690,127,122,91,226,208,2142,33,2175,3252,67.24666595
6300300-049,大安區建安里,909,771,147,136,92,391,216,2662,31,2693,4206,64.11000061
6300300-050,大安區建倫里,1141,997,205,135,121,404,264,3267,57,3324,5214,63.75500011
6300300-031,大安區通化里,1500,965,213,200,110,242,299,3529,60,3589,5321,67.34250069
6300300-032,大安區通安里,1213,973,176,191,113,295,295,3256,65,3321,4834,68.64749908
6300300-051,大安區敦安里,1275,924,168,179,103,329,317,3295,38,3333,5170,64.52499866
6300300-053,大安區敦煌里,1235,1019,159,181,112,369,292,3367,35,3402,5029,67.66999817
6300300-054,大安區華聲里,812,699,116,142,90,276,228,2363,31,2394,3618,66.30666478
6300300-023,大安區新龍里,915,1287,158,209,179,619,409,3776,47,3823,5553,68.85000038
6300300-037,大安區群英里,827,1535,211,234,165,733,438,4143,43,4186,6098,68.64749908
6300300-036,大安區群賢里,1058,1088,154,176,143,466,293,3378,40,3418,5111,66.83250046
6300300-030,大安區義安里,915,952,164,155,85,368,257,2896,32,2928,4563,64.06000042
6300300-006,大安區義村里,865,1189,187,180,118,553,315,3407,48,3455,5229,66.02499962
6300300-009,大安區誠安里,889,743,126,114,77,211,226,2386,34,2420,3666,66.02666728
6300300-017,大安區福住里,1172,915,197,192,165,351,333,3325,51,3376,4998,67.56749916
6300300-001,大安區德安里,1026,906,163,119,95,426,266,3001,52,3053,4789,63.74749947
6300300-046,大安區黎元里,1181,896,200,195,101,253,318,3144,65,3209,4749,67.69250107
6300300-047,大安區黎孝里,1537,1436,242,277,176,481,442,4591,56,4647,6664,69.75200043
6300300-048,大安區黎和里,891,927,141,175,97,305,245,2781,58,2839,4249,66.76000086
6300300-057,大安區學府里,465,568,85,51,57,183,184,1593,32,1625,2425,66.82999929
6300300-016,大安區錦安里,1055,926,174,202,152,328,328,3165,26,3191,4763,66.96249962
6300300-020,大安區錦泰里,606,620,87,96,85,197,205,1896,26,1922,2828,67.95000076
6300300-021,大安區錦華里,1024,1005,138,195,126,296,326,3110,31,3141,4464,70.35000102
6300300-028,大安區龍生里,1186,1127,171,202,152,421,386,3645,50,3695,5394,68.47499847
6300300-015,大安區龍安里,1220,982,189,219,141,373,360,3484,57,3541,6531,59.76000214
6300300-011,大安區龍坡里,1028,945,152,171,165,371,377,3209,48,3257,4732,68.92500114
6300300-041,大安區龍門里,817,659,89,139,135,257,295,2391,27,2418,3494,69.22999827
6300300-012,大安區龍泉里,1005,769,133,143,124,214,269,2657,22,2679,3934,68.07666779
6300300-026,大安區龍陣里,715,595,88,118,95,220,249,2080,22,2102,3080,68.26499939
6300300-040,大安區龍淵里,1736,1464,254,316,268,562,546,5146,56,5202,7422,70.05800171
6300300-027,大安區龍雲里,999,838,97,128,106,300,258,2726,35,2761,4134,66.73666763
6300300-022,大安區龍圖里,1221,1197,182,210,129,438,368,3745,44,3789,5729,66.00249958
6300300-033,大安區臨江里,913,740,150,136,74,186,245,2444,39,2483,3595,69.02333323
6300400-039,中山區力行里,1513,867,191,213,114,227,283,3408,52,3460,5179,66.79250145
6300400-027,中山區下埤里,2030,1168,249,311,180,263,361,4562,62,4624,6584,70.25399933
6300400-017,中山區大佳里,385,110,31,30,16,17,40,629,10,639,935,68.33999634
6300400-014,中山區大直里,1935,1743,298,353,220,470,494,5513,66,5579,7828,71.22400055
6300400-006,中山區中山里,1468,920,230,212,136,202,296,3464,53,3517,5678,61.89750004
6300400-033,中山區中央里,872,558,126,120,73,154,165,2068,26,2094,3017,69.41999817
6300400-030,中山區中吉里,1549,759,189,212,102,158,260,3229,34,3263,4683,69.6899999
6300400-023,中山區中庄里,1419,740,207,125,110,131,245,2977,33,3010,4488,67.08999888
6300400-031,中山區中原里,1352,751,150,206,122,167,225,2973,37,3010,4352,69.12000275
6300400-042,中山區北安里,480,503,83,102,71,193,120,1552,18,1570,2296,68.23500061
6300400-001,中山區正守里,787,478,98,136,51,144,153,1847,27,1874,2777,67.60499954
6300400-003,中山區正得里,823,600,107,128,77,162,152,2049,22,2071,3303,62.67499924
6300400-002,中山區正義里,1090,761,180,177,98,180,248,2734,44,2778,4577,60.69666672
6300400-004,中山區民安里,1231,670,169,135,85,166,218,2674,37,2711,4042,67.00999959
6300400-016,中山區永安里,2073,1531,276,323,207,423,423,5256,63,5319,7678,69.37200317
6300400-015,中山區成功里,1407,964,208,223,125,287,257,3471,32,3503,5280,66.34000206
6300400-038,中山區朱崙里,725,450,96,79,38,101,146,1635,20,1655,2473,66.92499924
6300400-036,中山區朱園里,1143,614,130,160,105,161,225,2538,38,2576,3975,64.8100001
6300400-034,中山區朱馥里,1361,951,202,208,104,230,255,3311,53,3364,5075,66.26666768
6300400-029,中山區江山里,2055,1126,221,302,143,274,354,4475,48,4523,6510,69.44250107
6300400-028,中山區江寧里,1702,1065,203,221,133,343,336,4003,58,4061,5905,68.71750259
6300400-025,中山區行仁里,2236,1204,266,348,121,197,401,4773,73,4846,7043,68.83799896
6300400-026,中山區行孝里,1148,546,141,128,74,113,202,2352,27,2379,3550,67.06666565
6300400-024,中山區行政里,1525,902,216,220,119,217,278,3477,47,3524,6793,58.02333196
6300400-021,中山區松江里,1791,1008,216,238,123,190,310,3876,48,3924,5615,69.86500168
6300400-041,中山區金泰里,1426,1156,271,271,119,347,353,3943,54,3997,5952,67.22749996
6300400-010,中山區恆安里,1033,687,147,166,93,155,260,2541,36,2577,4158,62.18000031
6300400-037,中山區埤頭里,824,579,105,119,82,160,144,2013,26,2039,2978,68.53499985
6300400-005,中山區康樂里,572,418,106,85,35,104,106,1426,11,1437,2379,60.40500069
6300400-040,中山區復華里,953,776,171,143,83,268,245,2639,35,2674,3957,67.6299998
6300400-011,中山區晴光里,1161,809,203,157,83,170,260,2843,39,2882,4643,62.17666753
6300400-008,中山區集英里,1863,921,246,297,124,179,307,3937,64,4001,5927,67.50249863
6300400-012,中山區圓山里,1066,610,129,145,74,128,214,2366,37,2403,3696,64.96999868
6300400-022,中山區新生里,1426,720,150,177,86,149,250,2958,38,2996,4349,68.94333649
6300400-019,中山區新庄里,1339,745,157,174,91,178,248,2932,43,2975,4376,68.11333338
6300400-018,中山區新喜里,1450,738,198,226,99,154,246,3111,33,3144,4618,68.14333344
6300400-020,中山區新福里,1472,698,177,202,75,107,234,2965,41,3006,4418,68.04666646
6300400-007,中山區聚盛里,905,447,171,126,71,154,209,2083,40,2123,3700,57.18666712
6300400-009,中山區聚葉里,937,568,154,127,74,123,172,2155,33,2188,3440,63.62000084
6300400-013,中山區劍潭里,350,942,144,80,80,385,211,2192,33,2225,3214,69.32500076
6300400-032,中山區興亞里,1358,807,160,179,93,195,288,3080,40,3120,4594,67.95666758
6300400-035,中山區龍洲里,705,1252,197,150,104,424,247,3079,43,3122,4406,70.84666951
6300500-031,中正區三愛里,1742,1285,261,250,209,462,506,4715,53,4768,7022,67.93000031
6300500-029,中正區文北里,1162,852,160,169,130,278,341,3092,41,3133,4619,67.85333252
6300500-003,中正區文盛里,583,412,62,104,66,172,167,1566,12,1578,2258,69.82499695
6300500-030,中正區文祥里,1570,1240,208,261,181,407,382,4249,53,4302,6185,69.55000114
6300500-001,中正區水源里,641,488,89,110,64,122,146,1660,33,1693,2619,64.625
6300500-011,中正區永功里,1489,939,195,238,101,254,341,3557,54,3611,5252,68.67000008
6300500-012,中正區永昌里,1246,896,180,187,84,219,281,3093,52,3145,4470,70.42999776
6300500-023,中正區光復里,775,565,128,131,48,151,200,1998,26,2024,3112,64.89666875
6300500-027,中正區幸市里,1059,748,129,157,97,262,263,2715,30,2745,3908,70.25666809
6300500-026,中正區幸福里,973,714,138,162,76,206,250,2519,41,2560,3823,66.92666626
6300500-014,中正區忠勤里,1429,1185,257,203,77,287,363,3801,85,3886,5900,66.06249905
6300500-028,中正區東門里,737,721,117,126,99,265,201,2266,26,2292,3403,67.24999746
6300500-008,中正區板溪里,728,579,112,124,74,176,197,1990,44,2034,2967,68.56000137
6300500-004,中正區林興里,782,773,171,151,95,256,302,2530,39,2569,3944,65.0833346
6300500-005,中正區河堤里,863,800,169,183,108,326,290,2739,33,2772,4054,68.41666667
6300500-017,中正區南門里,480,555,83,87,51,191,141,1588,19,1607,2201,73.02500153
6300500-019,中正區南福里,2024,1668,319,322,225,469,544,5571,75,5646,8136,69.43199921
6300500-022,中正區建國里,264,240,63,54,27,78,66,792,8,800,1195,66.94999695
6300500-025,中正區梅花里,707,550,95,109,76,134,183,1854,13,1867,2815,66.40500069
6300500-006,中正區頂東里,1317,1057,174,245,126,341,416,3676,36,3712,5362,69.28000069
6300500-002,中正區富水里,333,478,100,90,46,159,162,1368,22,1390,2133,65.15499878
6300500-015,中正區廈安里,875,618,126,176,77,157,226,2255,31,2286,3416,67.07000224
6300500-016,中正區愛國里,697,520,105,99,59,158,154,1792,21,1813,2608,69.56499863
6300500-021,中正區新營里,1494,1561,280,284,204,490,500,4813,42,4855,6972,69.66199951
6300500-007,中正區網溪里,1187,969,186,242,151,358,347,3440,47,3487,5069,68.79750252
6300500-024,中正區黎明里,549,510,126,100,55,153,165,1658,22,1680,2715,61.87500191
6300500-009,中正區螢圃里,1116,979,166,208,111,328,326,3234,47,3281,4782,68.7025013
6300500-010,中正區螢雪里,987,821,157,179,94,229,262,2729,31,2760,3924,70.3666687
6300500-018,中正區龍光里,666,599,103,106,70,165,172,1881,20,1901,2740,69.375
6300500-020,中正區龍福里,1246,1038,204,207,130,280,294,3399,35,3434,5945,60.78333537
6300500-013,中正區龍興里,837,578,133,133,108,150,196,2135,27,2162,3166,68.32499695
6301000-012,內湖區大湖里,1100,882,193,233,157,294,313,3172,45,3217,4679,68.63666534
6301000-022,內湖區五分里,2246,1451,365,409,155,354,469,5449,111,5560,8604,64.64999962
6301000-009,內湖區內湖里,1196,969,192,232,97,294,302,3282,44,3326,5052,65.84666697
6301000-025,內湖區內溝里,1019,715,180,226,96,213,274,2723,60,2783,4073,68.48000081
6301000-028,內湖區石潭里,740,559,143,147,61,155,147,1952,40,1992,3128,63.64999962
6301000-033,內湖區安泰里,1095,938,207,209,86,197,291,3023,63,3086,4621,66.91333262
6301000-031,內湖區安湖里,1645,1226,242,358,128,307,398,4304,40,4344,6334,68.59500122
6301000-027,內湖區行善里,1710,1040,241,237,104,246,350,3928,69,3997,5763,69.28499985
6301000-003,內湖區西安里,1449,1133,235,279,139,379,382,3996,66,4062,5770,70.39249992
6301000-002,內湖區西康里,1825,1661,307,378,214,500,514,5399,102,5501,8005,68.70600128
6301000-001,內湖區西湖里,1853,1142,245,288,139,304,390,4361,126,4487,6478,69.25749969
6301000-032,內湖區秀湖里,1242,1057,211,217,136,386,311,3560,58,3618,5355,67.53333282
6301000-036,內湖區明湖里,1142,840,177,214,88,193,248,2902,54,2956,4358,67.82999929
6301000-023,內湖區東湖里,1852,1264,336,307,163,255,390,4567,50,4617,6832,67.54500008
6301000-034,內湖區金湖里,1750,1508,307,353,222,542,428,5110,73,5183,7607,68.21600037
6301000-014,內湖區金瑞里,1431,1119,229,272,130,296,359,3836,63,3899,5653,68.95999908
6301000-013,內湖區金龍里,1186,916,207,199,109,225,284,3126,54,3180,4661,68.23666636
6301000-040,內湖區南湖里,941,880,189,208,118,281,301,2918,32,2950,4318,68.43333181
6301000-035,內湖區康寧里,1647,1468,334,342,187,411,378,4767,54,4821,7173,67.25399933
6301000-017,內湖區清白里,1672,1389,334,318,178,473,424,4788,62,4850,7020,69.0760025
6301000-006,內湖區港都里,1296,917,203,229,100,210,258,3213,64,3277,4648,70.48999786
6301000-007,內湖區港富里,2222,1517,315,367,154,380,566,5521,74,5595,8007,69.9
6301000-008,內湖區港華里,2015,1470,309,370,201,346,480,5191,85,5276,7509,70.28600006
6301000-005,內湖區港墘里,1393,938,174,234,121,270,344,3474,49,3523,5046,69.80666606
6301000-030,內湖區湖元里,1255,844,168,232,106,248,287,3140,34,3174,4734,67.05000051
6301000-029,內湖區湖興里,1693,1111,263,300,134,292,374,4167,59,4226,7432,59.41249943
6301000-010,內湖區湖濱里,1482,1559,260,302,163,539,419,4724,87,4811,6914,69.67200012
6301000-011,內湖區紫星里,1877,1296,238,338,157,400,422,4728,79,4807,6856,70.10750008
6301000-019,內湖區紫陽里,1735,1300,269,323,176,477,460,4740,67,4807,6958,69.06750107
6301000-016,內湖區紫雲里,1051,1113,213,186,95,340,340,3338,78,3416,4955,68.94000244
6301000-026,內湖區週美里,1926,1248,254,257,134,281,328,4428,90,4518,6549,69.51249886
6301000-021,內湖區瑞光里,857,913,200,170,104,334,250,2828,42,2870,4050,70.95333354
6301000-020,內湖區瑞陽里,1371,1690,293,268,170,496,436,4724,73,4797,6747,71.11500168
6301000-018,內湖區葫洲里,1287,1145,240,281,147,373,335,3808,46,3854,5643,68.29750061
6301000-015,內湖區碧山里,1475,1107,223,295,136,322,381,3939,55,3994,5906,67.50999908
6301000-024,內湖區樂康里,1941,1270,320,340,144,301,431,4747,74,4821,7172,67.13999939
6301000-038,內湖區麗山里,1407,861,204,245,142,221,322,3402,50,3452,4962,69.55666606
6301000-039,內湖區寶湖里,1541,1303,267,251,173,403,370,4308,57,4365,6744,64.73999977
6301000-037,內湖區蘆洲里,332,166,49,56,11,13,50,677,17,694,1087,63.84999847
6300800-027,文山區木柵里,1335,1874,301,268,223,585,469,5055,79,5134,7404,69.3019989
6300800-028,文山區木新里,1856,1567,280,347,179,402,490,5121,87,5208,8752,61.85600052
6300800-037,文山區老泉里,302,108,19,24,7,8,38,506,18,524,761,68.86000061
6300800-038,文山區忠順里,634,797,131,133,94,339,233,2361,39,2400,3467,69.22000122
6300800-025,文山區明義里,587,816,123,85,54,177,178,2020,67,2087,3257,63.65666707
6300800-026,文山區明興里,1211,1350,228,229,161,386,354,3919,57,3976,5926,67.08500099
6300800-036,文山區指南里,849,560,144,109,117,156,214,2149,42,2191,3228,67.89999898
6300800-040,文山區政大里,1149,1120,223,277,222,428,419,3838,39,3877,5685,68.11750031
6300800-034,文山區博嘉里,1109,1042,186,179,104,268,292,3180,54,3234,4813,67.12000084
6300800-005,文山區景仁里,849,858,167,184,98,257,278,2691,34,2725,3906,69.79000092
6300800-001,文山區景行里,1529,1062,219,230,136,281,370,3827,55,3882,5704,68.0549984
6300800-002,文山區景東里,1137,1366,232,219,133,428,393,3908,64,3972,5892,67.40749931
6300800-003,文山區景美里,987,908,172,167,113,293,311,2951,52,3003,4292,70.05333201
6300800-006,文山區景華里,1085,1042,193,200,140,348,351,3359,46,3405,4890,69.59249878
6300800-004,文山區景慶里,1246,1163,207,231,155,317,352,3671,61,3732,5535,67.43249893
6300800-024,文山區華興里,1488,1678,326,305,192,551,513,5053,77,5130,7381,69.49599915
6300800-029,文山區順興里,1495,1352,295,274,132,382,415,4345,71,4416,6278,70.07600098
6300800-010,文山區萬年里,1101,969,163,193,149,287,332,3194,35,3229,4737,68.20500183
6300800-007,文山區萬有里,989,1012,176,197,132,321,313,3140,32,3172,4565,69.47666677
6300800-011,文山區萬和里,414,843,112,76,68,257,171,1941,26,1967,2822,69.73999786
6300800-033,文山區萬芳里,1277,1466,292,276,191,503,493,4498,49,4547,6730,67.55599976
6300800-039,文山區萬美里,1177,1248,256,231,194,443,452,4001,65,4066,6229,65.25500107
6300800-012,文山區萬盛里,786,921,162,185,118,316,310,2798,38,2836,4179,67.84333293
6300800-008,文山區萬祥里,932,817,152,151,109,253,259,2673,40,2713,3903,69.6899999
6300800-009,文山區萬隆里,1237,1357,245,257,184,463,431,4174,59,4233,6084,69.56599884
6300800-035,文山區萬興里,1541,1353,253,292,266,485,471,4661,76,4737,6834,69.25200043
6300800-023,文山區試院里,1043,1377,247,207,159,505,456,3994,65,4059,5828,69.67499924
6300800-041,文山區樟文里,1253,1095,203,207,115,341,333,3547,42,3589,5178,69.3049984
6300800-030,文山區樟林里,1407,1645,279,307,194,515,455,4802,70,4872,7149,68.1280014
6300800-031,文山區樟新里,975,993,168,193,136,345,298,3108,48,3156,4587,68.81000137
6300800-032,文山區樟腳里,1139,1008,176,204,116,283,306,3232,59,3291,4641,70.91333262
6300800-043,文山區樟樹里,964,865,187,160,103,260,236,2775,60,2835,4098,69.17666626
6300800-014,文山區興光里,573,640,134,114,79,205,184,1929,35,1964,2988,65.63499832
6300800-018,文山區興安里,967,1320,258,199,163,505,322,3734,52,3786,5496,68.89499855
6300800-042,文山區興邦里,731,971,149,179,115,381,263,2789,43,2832,4101,69.05333201
6300800-020,文山區興旺里,1215,1550,306,296,157,527,535,4586,60,4646,6994,66.39999924
6300800-022,文山區興昌里,1009,1142,233,216,169,478,490,3737,53,3790,5698,66.52999878
6300800-015,文山區興家里,1294,1483,273,231,175,455,463,4374,59,4433,6411,69.20200195
6300800-021,文山區興泰里,726,774,130,123,93,237,259,2342,31,2373,3423,69.32666524
6300800-016,文山區興得里,1037,1186,184,214,133,337,354,3445,66,3511,5126,68.55750084
6300800-017,文山區興業里,836,1112,175,186,120,426,266,3121,49,3170,4664,67.93000031
6300800-019,文山區興福里,1113,1038,164,202,125,302,306,3250,53,3303,4816,68.60499954
6300800-013,文山區興豐里,922,964,146,157,106,325,264,2884,47,2931,4128,71.05000051
6301200-037,北投區一德里,2039,1037,208,272,114,173,368,4211,58,4269,6178,69.09500122
6301200-018,北投區八仙里,1436,816,150,195,101,187,263,3148,49,3197,4662,68.53666433
6301200-041,北投區大屯里,396,106,32,34,9,21,64,662,20,682,1039,65.63999939
6301200-024,北投區大同里,1692,816,188,210,109,147,336,3498,59,3557,5088,69.94333394
6301200-027,北投區中心里,1504,884,182,224,135,231,378,3538,40,3578,5608,63.83750057
6301200-022,北投區中央里,2383,1257,239,312,159,191,443,4984,67,5051,7396,68.31399994
6301200-030,北投區中和里,1184,886,167,192,91,219,312,3051,50,3101,4373,70.55666606
6301200-028,北投區中庸里,1224,618,121,140,58,136,280,2577,50,2627,3865,67.87666575
6301200-033,北投區文化里,672,912,129,131,79,275,268,2466,28,2494,3509,71.03333537
6301200-002,北投區文林里,1213,647,123,158,89,100,205,2535,46,2581,3641,70.85000102
6301200-009,北投區永和里,2254,1309,299,323,157,383,476,5201,72,5273,7712,68.34599915
6301200-011,北投區永明里,1141,828,158,180,79,187,273,2846,38,2884,3989,72.23666382
6301200-010,北投區永欣里,1600,1292,225,305,180,466,428,4496,53,4549,6556,69.36249924
6301200-003,北投區石牌里,1496,810,180,205,110,164,290,3255,36,3291,4645,70.82666779
6301200-017,北投區立農里,2380,1339,247,368,168,309,475,5286,78,5364,7532,71.20399933
6301200-016,北投區立賢里,1404,777,165,199,110,178,280,3113,53,3166,4517,70.08333333
6301200-013,北投區吉利里,1508,1195,235,298,115,251,395,3997,48,4045,5672,71.30000114
6301200-014,北投區吉慶里,1431,772,142,233,82,161,269,3090,38,3128,4323,72.34666443
6301200-032,北投區秀山里,828,581,96,88,52,118,224,1987,40,2027,2931,69.22499847
6301200-020,北投區奇岩里,2420,1549,271,372,177,344,603,5736,82,5818,8270,70.34200134
6301200-012,北投區東華里,977,849,136,147,87,198,297,2691,37,2728,3721,73.3666687
6301200-026,北投區林泉里,635,615,106,108,56,144,190,1854,29,1883,3040,61.96500015
6301200-023,北投區長安里,1516,895,156,219,101,168,307,3362,67,3429,5218,65.7466685
6301200-001,北投區建民里,1170,635,124,162,72,164,248,2575,31,2606,3684,70.76333364
6301200-039,北投區泉源里,676,315,62,69,35,46,133,1336,41,1377,2082,66.60000229
6301200-019,北投區洲美里,757,193,65,82,19,25,106,1247,19,1266,1821,69.51999664
6301200-008,北投區振華里,1747,1357,240,256,160,348,434,4542,49,4591,6524,70.44499969
6301200-036,北投區桃源里,1638,936,176,239,106,165,316,3576,57,3633,5220,69.5775013
6301200-021,北投區清江里,2374,1329,268,258,125,224,483,5061,106,5167,8344,63.33000107
6301200-015,北投區尊賢里,1309,654,135,184,95,119,273,2769,42,2811,3939,71.34666697
6301200-031,北投區智仁里,1497,1031,158,207,113,216,340,3562,55,3617,5258,68.77333323
6301200-040,北投區湖山里,498,242,67,40,21,49,118,1035,24,1059,1602,66.25000191
6301200-042,北投區湖田里,251,136,40,36,10,17,68,558,14,572,891,64.19999695
6301200-029,北投區開明里,1563,1157,196,211,126,271,389,3913,41,3954,5701,69.3666687
6301200-025,北投區溫泉里,1719,1077,210,244,104,194,416,3964,44,4008,5827,68.80000114
6301200-007,北投區裕民里,1852,1232,263,263,162,289,428,4489,77,4566,6540,69.78750038
6301200-005,北投區榮光里,1777,1198,191,236,92,243,406,4143,63,4206,6098,68.96749878
6301200-006,北投區榮華里,1719,1229,222,308,183,358,443,4462,45,4507,6396,70.52750015
6301200-004,北投區福興里,1807,1102,215,238,112,229,406,4109,83,4192,5838,71.78749847
6301200-035,北投區稻香里,1159,870,184,194,66,169,229,2871,43,2914,4450,65.52333323
6301200-034,北投區豐年里,1171,796,148,160,46,121,240,2682,60,2742,3875,70.86999766
6301200-038,北投區關渡里,2924,1698,370,424,163,329,559,6467,123,6590,9670,68.1666654
6300100-004,松山區三民里,1405,1191,210,225,150,417,309,3907,39,3946,5816,67.79500008
6300100-026,松山區中正里,2147,1339,237,340,209,367,463,5102,51,5153,7649,67.28399963
6300100-027,松山區中崙里,898,740,117,153,66,149,182,2305,32,2337,3375,69.36000061
6300100-015,松山區中華里,1275,1021,200,205,128,420,305,3554,36,3590,5141,69.84999847
6300100-009,松山區介壽里,1035,656,125,154,120,227,202,2519,28,2547,3650,69.7633311
6300100-016,松山區民有里,2092,1402,240,260,195,454,475,5118,64,5182,7494,69.09833399
6300100-017,松山區民福里,1266,1204,245,234,140,463,345,3897,55,3952,5640,70.10749817
6300100-029,松山區吉仁里,831,666,119,145,83,175,213,2232,30,2262,3307,68.34999847
6300100-022,松山區吉祥里,1740,1368,283,299,154,514,456,4814,70,4884,7261,67.21600189
6300100-019,松山區安平里,2089,1323,261,306,150,357,448,4934,69,5003,7276,68.76600037
6300100-021,松山區自強里,1020,2370,340,245,213,1020,425,5633,84,5717,8188,69.78599854
6300100-011,松山區東光里,1492,1294,226,200,153,417,379,4161,63,4224,6247,67.56600037
6300100-013,松山區東昌里,642,412,87,86,57,129,135,1548,24,1572,2191,71.85499954
6300100-014,松山區東勢里,964,652,122,164,107,246,209,2464,36,2500,3700,67.5566686
6300100-003,松山區東榮里,1764,1244,217,252,170,502,390,4539,58,4597,6557,70.14200287
6300100-035,松山區松基里,880,584,103,128,60,151,167,2073,24,2097,3128,66.93999863
6300100-028,松山區美仁里,845,548,90,103,67,173,157,1983,28,2011,2848,70.61499786
6300100-002,松山區莊敬里,1085,995,198,192,104,243,294,3111,47,3158,4673,67.58999888
6300100-008,松山區富泰里,806,807,155,165,111,354,211,2609,38,2647,3966,66.89333344
6300100-006,松山區富錦里,1068,903,142,162,112,323,252,2962,32,2994,4421,67.76333364
6300100-032,松山區復建里,865,742,129,152,98,279,241,2506,34,2540,3674,69.05666351
6300100-025,松山區復盛里,1356,1224,236,242,130,332,317,3837,55,3892,5495,70.84666697
6300100-033,松山區復勢里,1450,989,205,206,135,253,315,3553,51,3604,5171,69.71749878
6300100-031,松山區復源里,661,563,116,98,68,143,186,1835,19,1854,2640,70.23999786
6300100-030,松山區敦化里,1606,1115,210,250,165,292,418,4056,47,4103,5706,71.94250107
6300100-018,松山區慈祐里,1694,926,261,275,136,237,348,3877,56,3933,6903,60.05000019
6300100-007,松山區新東里,1120,818,159,168,108,264,230,2867,43,2910,4169,69.81333415
6300100-005,松山區新益里,1163,796,137,187,138,220,203,2844,34,2878,4055,70.97666677
6300100-024,松山區新聚里,1876,1346,253,300,176,305,362,4618,59,4677,6818,68.58500099
6300100-034,松山區福成里,623,416,70,88,57,115,151,1520,18,1538,2241,68.61000061
6300100-010,松山區精忠里,910,725,122,108,85,283,199,2432,30,2462,3581,68.75666555
6300100-012,松山區龍田里,1400,1910,315,260,184,933,492,5494,66,5560,8293,67.06166649
6300100-020,松山區鵬程里,950,1055,190,184,127,439,268,3213,57,3270,4761,68.66666667
6300200-030,信義區三張里,1678,1668,305,314,180,612,482,5239,85,5324,7788,68.3383344
6300200-031,信義區三犁里,1060,918,182,136,89,357,254,2996,45,3041,4551,66.78999837
6300200-027,信義區大仁里,965,767,122,126,73,150,214,2417,50,2467,3584,68.83000183
6300200-026,信義區大道里,1577,1064,188,240,123,269,313,3774,53,3827,5418,70.62250137
6300200-025,信義區中行里,2023,1248,275,299,149,299,411,4704,67,4771,6984,68.38800049
6300200-024,信義區中坡里,1056,808,140,170,87,185,221,2667,34,2701,3923,68.92000198
6300200-004,信義區中興里,650,531,109,117,74,218,172,1871,18,1889,2969,63.66499901
6300200-013,信義區五全里,1384,841,167,199,91,170,284,3136,51,3187,4405,72.40666707
6300200-012,信義區五常里,869,652,116,134,77,150,183,2181,36,2217,3272,67.75999832
6300200-032,信義區六合里,1126,1333,219,237,144,500,328,3887,56,3943,5994,65.79750061
6300200-010,信義區六藝里,945,599,126,136,64,132,176,2178,31,2209,3155,69.88999939
6300200-016,信義區四育里,1479,916,174,219,120,190,337,3435,50,3485,4971,70.10749817
6300200-017,信義區四維里,1170,979,171,210,103,239,284,3156,56,3212,4753,67.57250023
6300200-002,信義區正和里,806,856,139,134,100,373,282,2690,29,2719,3927,69.24000041
6300200-014,信義區永吉里,1234,517,148,120,39,79,193,2330,57,2387,3543,67.40999858
6300200-018,信義區永春里,1232,770,148,165,88,189,286,2878,50,2928,4287,68.29500008
6300200-009,信義區安康里,2016,1595,325,335,175,567,485,5498,75,5573,8440,66.05571529
6300200-001,信義區西村里,585,1034,152,129,98,474,265,2737,38,2775,5218,58.1533343
6300200-022,信義區松友里,1384,1177,197,235,121,333,326,3773,55,3828,5724,66.9299984
6300200-023,信義區松光里,1167,836,174,183,77,213,249,2899,41,2940,4353,67.51666768
6300200-021,信義區松隆里,472,367,99,63,38,95,116,1250,22,1272,2009,63.36500168
6300200-015,信義區長春里,1016,701,133,155,98,142,222,2467,40,2507,3688,67.96333313
6300200-033,信義區泰和里,1534,1332,266,258,166,409,400,4365,80,4445,6840,65.03000031
6300200-020,信義區國業里,1499,1267,238,259,139,375,361,4138,59,4197,6233,67.33600006
6300200-019,信義區富臺里,672,877,145,116,83,302,224,2419,49,2468,3718,66.09999847
6300200-029,信義區惠安里,1170,1270,255,238,139,407,350,3829,79,3908,5768,67.70000076
6300200-007,信義區敦厚里,1054,883,169,183,112,283,282,2966,31,2997,4539,66.00000254
6300200-035,信義區景勤里,842,775,132,123,58,257,208,2395,42,2437,3585,67.93000031
6300200-028,信義區景新里,949,909,154,140,127,336,288,2903,54,2957,4375,67.6766688
6300200-034,信義區景聯里,1006,835,159,179,94,268,247,2788,50,2838,4035,70.29666646
6300200-011,信義區雅祥里,1233,819,155,168,108,162,233,2878,21,2899,4269,67.97666931
6300200-005,信義區新仁里,571,637,131,117,75,219,224,1974,22,1996,2930,68.19000244
6300200-037,信義區嘉興里,752,518,88,110,66,177,173,1884,29,1913,2853,67
6300200-008,信義區廣居里,1597,1367,238,286,161,448,401,4498,62,4560,6616,68.94600067
6300200-039,信義區黎平里,1449,1293,241,259,131,378,398,4149,43,4192,6169,67.95249939
6300200-041,信義區黎安里,340,599,62,45,24,102,96,1268,43,1311,1941,67.56000137
6300200-040,信義區黎忠里,1055,869,148,139,123,286,243,2863,56,2919,4244,68.84000142
6300200-038,信義區黎順里,846,738,122,145,81,256,203,2391,36,2427,3713,65.45333481
6300200-003,信義區興隆里,474,479,96,82,55,208,130,1524,23,1547,2471,62.61499977
6300200-006,信義區興雅里,1247,974,178,223,107,318,291,3338,44,3382,5034,67.17250061
6300200-036,信義區雙和里,1416,1347,256,248,151,440,407,4265,53,4318,6159,70.08250237
6300900-018,南港區九如里,1207,1238,240,218,112,281,318,3614,76,3690,5467,67.49999809
6300900-004,南港區三重里,1351,968,250,205,110,256,337,3477,43,3520,5516,63.83500099
6300900-002,南港區中南里,967,556,132,127,38,108,170,2098,50,2148,3234,66.40500259
6300900-017,南港區中研里,2006,1502,291,479,210,295,523,5306,107,5413,7828,69.20800018
6300900-019,南港區仁福里,1003,997,265,202,86,357,312,3222,60,3282,4805,68.23250008
6300900-009,南港區玉成里,1291,714,167,167,74,156,304,2873,43,2916,4222,69.1299998
6300900-010,南港區合成里,1752,1151,230,225,107,236,348,4049,71,4120,6009,68.57200012
6300900-011,南港區成福里,1604,1436,311,267,144,350,412,4524,82,4606,6543,70.39799957
6300900-014,南港區百福里,1267,908,186,191,93,175,279,3099,57,3156,4646,67.94999949
6300900-008,南港區西新里,1301,616,160,196,65,128,255,2721,47,2768,4065,68.09333293
6300900-007,南港區東明里,1013,829,172,185,90,201,235,2725,43,2768,4023,68.8100001
6300900-005,南港區東新里,1671,1216,239,273,90,211,354,4054,110,4164,6135,67.97249985
6300900-001,南港區南港里,1349,918,203,247,102,201,264,3284,48,3332,5318,63.25249767
6300900-020,南港區重陽里,1010,798,228,214,119,270,241,2880,50,2930,4214,69.47666677
6300900-006,南港區新光里,828,752,159,131,58,150,181,2259,46,2305,3272,70.47000122
6300900-003,南港區新富里,1021,585,128,173,56,127,190,2280,50,2330,3412,68.37333425
6300900-012,南港區萬福里,936,851,162,169,88,178,221,2605,43,2648,3655,72.42666626
6300900-015,南港區聯成里,1130,922,182,193,92,231,252,3002,56,3058,4415,69.29000092
6300900-013,南港區鴻福里,1072,819,166,152,100,200,247,2756,46,2802,4026,69.54666901
6300900-016,南港區舊莊里,2121,1319,322,359,146,268,452,4987,128,5115,7839,65.27999954
6300700-009,萬華區仁德里,1232,795,159,202,97,169,273,2927,30,2957,4209,70.39333344
6300700-033,萬華區日祥里,1042,1273,224,156,73,319,312,3399,73,3472,4839,71.49500084
6300700-020,萬華區日善里,1076,565,127,153,56,102,210,2289,41,2330,3199,72.86000061
6300700-026,萬華區全德里,1129,685,132,205,58,141,212,2562,29,2591,3637,71.22666677
6300700-003,萬華區西門里,796,567,153,130,76,154,193,2069,35,2104,3369,62.47500038
6300700-023,萬華區孝德里,1052,458,120,160,54,61,170,2075,51,2126,2915,73.24000168
6300700-016,萬華區和平里,2169,883,219,300,87,153,379,4190,76,4266,6114,69.78499985
6300700-024,萬華區和德里,1997,1018,207,225,69,126,386,4028,76,4104,6141,66.67499924
6300700-034,萬華區忠貞里,807,1227,164,122,60,370,240,2990,52,3042,4355,69.89666494
6300700-022,萬華區忠德里,1327,567,127,157,61,106,219,2564,42,2606,3738,69.71666718
6300700-006,萬華區青山里,1632,848,212,175,63,152,296,3378,63,3441,5155,66.58250046
6300700-027,萬華區保德里,896,592,92,142,66,94,161,2043,21,2064,2865,72.1649971
6300700-019,萬華區柳鄉里,1640,720,176,185,56,93,314,3184,49,3233,4746,68.18000031
6300700-035,萬華區凌霄里,704,815,176,131,38,207,204,2275,45,2320,3334,69.64666748
6300700-011,萬華區頂碩里,2318,1049,219,272,115,161,378,4512,68,4580,6458,70.89399872
6300700-007,萬華區富民里,1570,704,122,175,65,110,233,2979,50,3029,4448,68.11666361
6300700-010,萬華區富福里,1471,759,142,195,68,113,223,2971,37,3008,5550,59.53333155
6300700-005,萬華區菜園里,1743,914,202,195,77,167,300,3598,54,3652,5347,68.32999992
6300700-032,萬華區華中里,1882,1004,185,233,95,170,329,3898,54,3952,5397,73.26249886
6300700-018,萬華區華江里,2351,1247,291,349,135,244,377,4994,81,5075,7413,68.51999969
6300700-021,萬華區新安里,1234,1148,272,155,104,340,292,3545,86,3631,5452,66.62749863
6300700-014,萬華區新和里,1181,2096,299,257,143,861,401,5238,76,5314,7548,70.42799988
6300700-013,萬華區新忠里,393,932,135,80,56,344,159,2099,41,2140,3171,67.35000229
6300700-004,萬華區新起里,1701,982,236,224,85,217,330,3775,62,3837,5716,67.18749905
6300700-002,萬華區萬壽里,748,559,120,92,39,120,146,1824,34,1858,3060,60.69999886
6300700-030,萬華區壽德里,1408,850,159,205,65,173,254,3114,38,3152,4506,69.96666463
6300700-029,萬華區榮德里,1110,571,113,123,37,82,183,2219,57,2276,3190,71.43000031
6300700-001,萬華區福星里,1194,910,192,155,75,223,275,3024,51,3075,4775,64.37333298
6300700-008,萬華區福音里,1003,523,105,136,57,100,179,2103,52,2155,3061,70.35499954
6300700-017,萬華區綠堤里,1132,712,165,116,26,130,206,2487,58,2545,3823,66.40333557
6300700-028,萬華區銘德里,1388,750,140,188,45,138,222,2871,53,2924,4120,70.95333099
6300700-015,萬華區糖廍里,1582,830,158,205,105,190,247,3317,62,3379,4882,69.23000081
6300700-031,萬華區興德里,1344,710,157,210,86,106,253,2866,58,2924,4177,69.97666677
6300700-025,萬華區錦德里,1645,808,189,186,89,157,283,3357,56,3413,4876,69.96666718
6300700-012,萬華區雙園里,1328,647,170,171,85,117,215,2733,55,2788,3986,69.93333435
6300700-036,萬華區騰雲里,641,640,101,106,58,219,141,1906,30,1936,2698,71.73999786
6502300-010,八里區下罟里,348,257,63,32,17,21,190,928,35,963,1343,71.70999908
6502300-003,八里區大崁里,736,433,118,92,25,40,169,1613,39,1652,2389,69.15000153
6502300-002,八里區米倉里,799,463,125,113,50,75,206,1831,29,1860,2991,62.58999825
6502300-009,八里區長坑里,437,256,69,30,13,13,140,958,27,985,1387,71.01999664
6502300-008,八里區荖阡里,437,255,68,55,16,30,169,1030,23,1053,1550,67.94000244
6502300-007,八里區訊塘里,963,573,184,120,42,97,312,2291,42,2333,3714,62.82999992
6502300-004,八里區埤頭里,1019,495,150,102,34,69,213,2082,29,2111,3273,64.5
6502300-005,八里區頂罟里,485,295,88,45,23,28,125,1089,24,1113,1638,67.94999695
6502300-001,八里區龍源里,1652,1060,291,227,99,202,456,3987,71,4058,6142,66.24333445
6502300-006,八里區舊城里,1676,976,254,210,77,129,381,3703,70,3773,5916,63.74250126
6502100-001,三芝區八賢里,90,32,5,7,2,4,67,207,4,211,327,64.52999878
6502100-003,三芝區古庄里,230,155,30,20,10,22,128,595,16,611,980,62.34999847
6502100-012,三芝區店子里,218,71,20,17,6,4,70,406,14,420,606,69.30999756
6502100-009,三芝區後厝里,406,405,60,54,19,80,174,1198,21,1219,2014,60.52999878
6502100-006,三芝區茂長里,143,101,17,29,9,19,96,414,9,423,601,70.37999725
6502100-005,三芝區埔坪里,1238,1095,188,166,62,109,523,3381,91,3472,5954,58.36250019
6502100-002,三芝區埔頭里,1009,752,180,135,62,51,435,2624,71,2695,4428,60.89000066
6502100-011,三芝區圓山里,134,76,10,8,1,5,81,315,16,331,533,62.09999847
6502100-004,三芝區新庄里,209,183,19,10,10,14,89,534,17,551,829,66.47000122
6502100-010,三芝區福德里,155,137,29,31,18,31,85,486,18,504,764,65.97000122
6502100-007,三芝區橫山里,101,103,4,7,3,12,87,317,10,327,508,64.37000275
6502100-013,三芝區興華里,337,169,37,39,11,24,103,720,23,743,1152,64.5
6502100-008,三芝區錫板里,186,118,12,15,6,10,139,486,12,498,722,68.98000336
6500200-002,三重區二重里,518,207,56,65,19,23,78,966,15,981,1420,69.08000183
6500200-019,三重區三民里,954,437,113,141,37,55,148,1885,21,1906,2814,67.74499893
6500200-072,三重區三安里,806,393,127,110,32,42,110,1620,19,1639,2422,67.70999908
6500200-028,三重區大同里,516,297,71,69,22,37,101,1113,25,1138,1701,66.90000153
6500200-031,三重區大安里,412,274,61,53,15,46,85,946,17,963,1443,66.73999786
6500200-001,三重區大有里,1643,702,195,360,74,93,261,3328,43,3371,4683,71.96999868
6500200-042,三重區大園里,801,346,126,107,25,38,112,1555,18,1573,2257,69.67499924
6500200-060,三重區大德里,250,117,40,29,15,13,44,508,7,515,736,69.97000122
6500200-041,三重區中山里,784,370,96,99,35,47,108,1539,22,1561,2312,67.60000229
6500200-052,三重區中央里,601,267,72,58,28,17,79,1122,16,1138,1556,73.13999939
6500200-026,三重區中正里,398,216,75,62,27,23,83,884,22,906,1263,71.73000336
6500200-029,三重區中民里,345,244,52,42,26,14,57,780,24,804,1151,69.84999847
6500200-005,三重區中興里,1251,530,158,137,51,68,174,2369,42,2411,3303,72.8900032
6500200-109,三重區五谷里,562,261,82,74,23,23,88,1113,18,1131,1582,71.45000076
6500200-095,三重區五常里,1320,566,156,153,38,50,207,2490,50,2540,3590,70.75999959
6500200-104,三重區五華里,1505,602,220,228,65,96,232,2948,48,2996,4352,68.91000112
6500200-119,三重區五順里,1177,515,124,141,42,62,191,2252,46,2298,3350,68.59999847
6500200-096,三重區五福里,1060,488,138,141,40,75,183,2125,16,2141,3246,65.93999863
6500200-097,三重區仁忠里,929,430,139,113,30,41,131,1813,37,1850,2758,67.00500107
6500200-118,三重區仁華里,1322,536,190,164,41,69,201,2523,49,2572,3699,69.77666728
6500200-034,三重區仁義里,326,166,59,36,16,23,68,694,15,709,1012,70.05999756
6500200-032,三重區仁德里,624,264,74,80,16,34,93,1185,25,1210,1812,66.65999985
6500200-065,三重區介壽里,317,201,41,49,20,15,58,701,16,717,1045,68.61000061
6500200-077,三重區六合里,1122,532,171,147,40,45,183,2240,44,2284,3255,70.11999893
6500200-078,三重區六福里,1726,676,199,244,90,92,249,3276,48,3324,4766,69.69666799
6500200-051,三重區文化里,739,363,94,99,26,32,128,1481,20,1501,2072,72.47499847
6500200-030,三重區平和里,434,229,75,49,15,29,88,919,29,948,1398,67.80999756
6500200-049,三重區正安里,567,289,103,73,30,35,94,1191,28,1219,1747,69.77999878
6500200-048,三重區正義里,576,283,91,71,28,46,72,1167,22,1189,1619,73.44000244
6500200-047,三重區正德里,365,181,41,37,9,18,53,704,26,730,1011,72.20999908
6500200-045,三重區民生里,1351,598,160,156,55,70,204,2594,46,2640,3739,70.66000112
6500200-112,三重區永吉里,866,439,118,122,30,38,133,1746,28,1774,2571,68.95500183
6500200-091,三重區永安里,1238,543,150,144,47,84,194,2400,39,2439,3455,70.63999939
6500200-025,三重區永春里,572,308,83,77,23,35,111,1209,28,1237,1679,73.66999817
6500200-090,三重區永清里,1717,629,210,254,79,66,242,3197,45,3242,4759,68.11666616
6500200-088,三重區永盛里,1055,430,155,119,39,49,128,1975,31,2006,2843,70.52500153
6500200-113,三重區永發里,1831,712,241,294,77,114,244,3513,39,3552,4959,71.63666534
6500200-114,三重區永順里,1550,562,207,209,63,42,199,2832,47,2879,4272,67.43000031
6500200-092,三重區永煇里,918,297,92,104,30,46,113,1600,26,1626,2256,72.08000183
6500200-089,三重區永福里,1741,645,187,209,68,60,235,3145,51,3196,4536,70.48666636
6500200-087,三重區永德里,1544,601,198,164,51,84,228,2870,63,2933,4223,69.52666473
6500200-040,三重區永興里,364,208,46,58,22,37,60,795,13,808,1170,69.05999756
6500200-115,三重區永豐里,1724,674,222,217,66,69,251,3223,64,3287,4807,68.33333333
6500200-017,三重區田中里,2035,782,220,277,82,104,289,3789,59,3848,5335,72.24500084
6500200-015,三重區田心里,1311,539,172,166,43,57,190,2478,43,2521,3597,70.07999929
6500200-018,三重區田安里,1819,847,270,246,72,113,345,3712,76,3788,5307,71.40333303
6500200-116,三重區立德里,1052,484,143,138,42,58,165,2082,26,2108,2934,71.84999847
6500200-021,三重區光正里,620,402,83,105,44,67,104,1425,15,1440,2148,67.04499817
6500200-013,三重區光田里,1354,704,173,197,69,108,220,2825,50,2875,3915,73.48666636
6500200-020,三重區光明里,1852,1050,330,314,111,162,359,4178,47,4225,6184,68.31750107
6500200-057,三重區光華里,567,286,102,72,19,39,84,1169,17,1186,1743,68.04000092
6500200-014,三重區光陽里,1862,996,248,267,82,144,343,3942,58,4000,5485,72.93000221
6500200-035,三重區光榮里,409,212,74,46,24,24,82,871,18,889,1274,69.77999878
6500200-036,三重區光輝里,459,271,58,55,11,29,78,961,15,976,1365,71.5
6500200-027,三重區吉利里,376,217,67,63,17,35,83,858,20,878,1296,67.75
6500200-022,三重區同安里,370,197,64,48,11,34,82,806,22,828,1257,65.87000275
6500200-023,三重區同慶里,462,286,73,69,26,61,95,1072,23,1095,1574,69.56999969
6500200-075,三重區安慶里,689,288,81,84,27,35,98,1302,25,1327,1825,72.74000168
6500200-007,三重區成功里,1555,876,262,248,75,169,276,3461,55,3516,5054,69.77750206
6500200-050,三重區自強里,596,254,90,84,22,36,83,1165,26,1191,1636,72.80000305
6500200-070,三重區秀江里,402,218,45,39,13,23,78,818,14,832,1203,69.16000366
6500200-004,三重區谷王里,332,174,42,35,11,22,37,653,11,664,870,76.31999969
6500200-085,三重區尚德里,888,449,142,118,38,91,151,1877,32,1909,2714,70.22999954
6500200-076,三重區幸福里,1352,571,204,167,49,106,212,2661,45,2706,3953,68.48666636
6500200-033,三重區忠孝里,492,254,69,63,18,37,90,1023,18,1041,1535,67.81999969
6500200-080,三重區承德里,533,284,70,72,19,47,93,1118,30,1148,1609,71.34999847
6500200-061,三重區長元里,753,366,124,94,26,37,109,1509,33,1542,2191,70.37999725
6500200-058,三重區長生里,271,102,36,34,13,14,52,522,8,530,789,67.16999817
6500200-056,三重區長安里,669,335,98,91,33,38,97,1361,12,1373,2007,68.2899971
6500200-062,三重區長江里,644,280,88,78,16,56,98,1260,20,1280,1818,70.41000366
6500200-063,三重區長泰里,741,262,110,73,24,37,99,1346,22,1368,2013,67.90499878
6500200-064,三重區長福里,471,211,80,48,25,33,79,947,17,964,1411,68.31999969
6500200-074,三重區信安里,547,280,70,73,25,44,82,1121,17,1138,1714,66.38999939
6500200-083,三重區厚德里,1047,534,142,154,39,51,199,2166,36,2202,3021,72.88499832
6500200-071,三重區奕壽里,534,230,73,69,21,35,88,1050,30,1080,1580,68.34999847
6500200-012,三重區重明里,1025,498,129,160,49,70,165,2096,49,2145,2984,71.88999939
6500200-044,三重區重陽里,1033,578,124,133,62,68,188,2186,41,2227,3147,70.76499939
6500200-046,三重區重新里,492,192,41,56,27,18,67,893,12,905,1280,70.69999695
6500200-043,三重區國隆里,751,467,116,112,46,57,129,1678,35,1713,2348,72.93500137
6500200-086,三重區培德里,1165,518,141,162,55,61,175,2277,22,2299,3237,71.02000046
6500200-082,三重區崇德里,1331,540,145,132,37,77,184,2446,51,2497,3541,70.58666738
6500200-039,三重區清和里,1097,622,164,152,63,62,176,2336,37,2373,3314,71.61500168
6500200-003,三重區頂崁里,793,305,97,89,33,22,123,1462,19,1481,1998,74.11999893
6500200-110,三重區博愛里,1328,672,203,189,66,102,188,2748,52,2800,4027,69.51999919
6500200-106,三重區富華里,932,399,111,139,34,50,154,1819,28,1847,2771,66.59000015
6500200-105,三重區富貴里,1580,845,243,222,105,170,280,3445,46,3491,5197,67.15000153
6500200-107,三重區富福里,614,240,75,64,19,28,94,1134,22,1156,1789,64.60499954
6500200-024,三重區菜寮里,620,343,67,108,27,43,116,1324,27,1351,1875,72.20499802
6500200-059,三重區開元里,453,223,67,68,21,29,66,927,20,947,1304,72.62000275
6500200-079,三重區順德里,695,328,113,85,25,30,94,1370,29,1399,2025,69.03499985
6500200-102,三重區慈化里,750,333,113,106,29,28,118,1477,24,1501,2198,68.27999878
6500200-099,三重區慈生里,763,329,92,89,13,31,134,1451,27,1478,2089,70.74499893
6500200-103,三重區慈祐里,1505,631,171,165,55,51,249,2827,49,2876,4047,71.01999919
6500200-100,三重區慈惠里,761,250,85,101,29,28,97,1351,27,1378,1942,70.91999817
6500200-101,三重區慈愛里,1164,464,129,123,31,38,196,2145,32,2177,3172,68.56999969
6500200-098,三重區慈福里,736,277,95,61,21,24,121,1335,38,1373,2030,67.68499756
6500200-093,三重區溪美里,2321,1057,350,362,103,118,367,4678,78,4756,6775,70.16750145
6500200-081,三重區瑞德里,781,333,97,87,26,21,106,1451,23,1474,2063,71.50999832
6500200-066,三重區萬壽里,545,355,88,113,28,50,83,1262,31,1293,1794,72.03499985
6500200-010,三重區過田里,1599,967,267,251,94,174,320,3672,50,3722,8040,58.17249918
6500200-108,三重區碧華里,1752,959,237,269,95,181,276,3769,34,3803,5708,66.60000229
6500200-009,三重區福民里,1070,476,108,132,44,54,139,2023,31,2054,3014,68.15000153
6500200-016,三重區福田里,1201,501,136,153,49,61,166,2267,43,2310,3175,72.73500061
6500200-073,三重區福安里,934,426,126,122,41,44,139,1832,30,1862,2651,70.22999954
6500200-038,三重區福利里,614,349,98,102,32,56,92,1343,19,1362,2023,67.36499786
6500200-037,三重區福星里,281,146,39,39,18,25,50,598,18,616,901,68.37000275
6500200-008,三重區福祉里,1504,779,216,254,86,99,244,3182,39,3221,4650,69.58666484
6500200-094,三重區福隆里,1231,568,158,203,74,60,184,2478,38,2516,3758,66.95333354
6500200-111,三重區福德里,1157,571,157,142,44,88,183,2342,29,2371,3370,70.42499924
6500200-117,三重區福樂里,1138,485,141,143,39,41,156,2143,34,2177,3223,67.50999832
6500200-084,三重區維德里,998,380,113,113,35,37,127,1803,25,1828,2543,71.80500031
6500200-006,三重區德厚里,158,62,12,16,4,7,24,283,4,287,384,74.73999786
6500200-011,三重區錦田里,626,252,90,93,29,31,89,1210,19,1229,1809,67.88499832
6500200-055,三重區錦安里,551,277,80,63,22,32,74,1099,25,1124,1637,68.65999985
6500200-067,三重區錦江里,759,330,117,76,23,35,124,1464,33,1497,2137,70.05499649
6500200-054,三重區錦通里,449,260,79,57,11,24,96,976,28,1004,1375,73.01999664
6500200-069,三重區龍門里,549,231,74,86,29,37,94,1100,25,1125,1658,67.84999847
6500200-068,三重區龍濱里,989,446,142,135,39,72,124,1947,33,1980,2821,70.24000168
6500200-053,三重區雙園里,252,151,39,49,11,31,52,585,12,597,870,68.62000275
6500900-026,三峽區二鬮里,717,546,184,101,35,81,150,1814,30,1844,2951,62.48999977
6500900-003,三峽區八張里,961,595,165,159,46,72,181,2179,35,2214,3203,69.06999969
6500900-001,三峽區三峽里,92,62,9,6,7,11,10,197,4,201,281,71.52999878
6500900-010,三峽區大埔里,997,630,195,94,42,76,187,2221,28,2249,3485,64.9399999
6500900-025,三峽區中正里,1343,720,220,144,61,68,193,2749,51,2800,4293,65.13666662
6500900-004,三峽區中埔里,616,407,117,100,29,52,105,1426,26,1452,2241,64.875
6500900-014,三峽區五寮里,248,139,43,22,6,21,37,516,21,537,841,63.84999847
6500900-023,三峽區介壽里,1609,786,271,205,75,100,244,3290,58,3348,5511,60.94250011
6500900-005,三峽區弘道里,409,168,40,28,8,13,47,713,8,721,1037,69.52999878
6500900-006,三峽區永舘里,1892,1081,303,262,100,105,317,4060,79,4139,6135,67.46199951
6500900-021,三峽區安坑里,553,171,35,22,10,4,61,856,23,879,1285,68.40000153
6500900-024,三峽區安溪里,1674,1045,365,228,94,132,266,3804,82,3886,6141,63.22249889
6500900-020,三峽區成福里,355,162,28,30,3,17,39,634,7,641,853,75.15000153
6500900-016,三峽區有木里,234,102,43,23,5,6,40,453,13,466,727,64.09999847
6500900-022,三峽區竹崙里,674,228,83,45,13,34,105,1182,21,1203,1865,64.71500206
6500900-002,三峽區秀川里,168,113,24,16,7,12,27,367,6,373,563,66.25
6500900-013,三峽區金圳里,147,76,27,17,4,9,32,312,7,319,483,66.05000305
6500900-012,三峽區添福里,382,156,57,29,5,11,34,674,20,694,1033,67.18000031
6500900-015,三峽區插角里,262,123,27,16,3,4,38,473,12,485,712,68.12000275
6500900-017,三峽區溪北里,736,317,105,76,27,30,93,1384,24,1408,2000,69.75
6500900-019,三峽區溪東里,799,512,119,81,30,50,125,1716,41,1757,2628,66.63000107
6500900-018,三峽區溪南里,481,206,56,50,15,18,91,917,30,947,1342,70.56999969
6500900-011,三峽區嘉添里,557,503,116,75,23,61,98,1433,42,1475,2279,64.49500275
6500900-008,三峽區鳶山里,2308,1318,413,345,127,154,370,5035,85,5120,8118,63.08166567
6500900-009,三峽區龍埔里,2055,1223,394,246,123,169,391,4601,85,4686,7283,64.43600006
6500900-028,三峽區龍恩里,953,830,217,154,95,194,287,2730,19,2749,4386,62.51000086
6500900-027,三峽區龍學里,2319,1990,537,498,230,623,734,6931,65,6996,10582,66.19857243
6500900-007,三峽區礁溪里,1275,783,281,191,74,91,225,2920,44,2964,4589,64.59999847
6501300-002,土城區土城里,519,354,89,58,29,48,90,1187,25,1212,1774,68.36999893
6501300-020,土城區大安里,1244,659,191,176,48,124,260,2702,53,2755,4091,67.69666545
6501300-041,土城區中正里,774,493,110,129,66,79,156,1807,24,1831,2701,67.86000061
6501300-007,土城區日和里,1580,809,193,207,57,78,360,3284,46,3330,4939,67.41500092
6501300-006,土城區日新里,1304,671,181,171,44,80,234,2685,46,2731,3996,68.43333435
6501300-018,土城區平和里,1865,976,299,299,101,145,302,3987,78,4065,6009,67.62249947
6501300-038,土城區永富里,1354,747,219,191,55,105,227,2898,44,2942,4481,65.59666824
6501300-021,土城區永寧里,1926,1163,326,276,83,168,374,4316,78,4394,6887,63.82000046
6501300-014,土城區永豐里,1048,709,153,164,53,87,206,2420,36,2456,3693,66.5033315
6501300-031,土城區安和里,1409,616,220,192,60,103,206,2806,47,2853,4241,67.51333364
6501300-019,土城區廷寮里,1356,686,196,165,71,91,196,2761,45,2806,4051,69.32333374
6501300-022,土城區沛陂里,1223,619,174,154,41,71,181,2463,51,2514,3757,66.87333425
6501300-034,土城區延吉里,1291,541,189,148,34,72,215,2490,41,2531,3820,66.59666697
6501300-040,土城區延和里,1616,909,264,240,97,142,292,3560,57,3617,5471,66.22500038
6501300-047,土城區延祿里,1120,546,149,117,57,73,152,2214,41,2255,3569,63.18000031
6501300-030,土城區延壽里,1254,656,195,134,43,95,197,2574,40,2614,3942,66.34333293
6501300-043,土城區明德里,1247,940,183,252,128,152,246,3148,41,3189,4746,67.16666667
6501300-046,土城區金城里,1252,974,237,196,56,167,223,3105,51,3156,5009,62.94666545
6501300-005,土城區長風里,242,580,105,59,30,136,100,1252,15,1267,1728,73.31999969
6501300-045,土城區青山里,808,466,114,116,46,63,131,1744,37,1781,2674,66.47999954
6501300-032,土城區青雲里,768,448,124,111,32,68,141,1692,29,1721,2514,68.43500137
6501300-009,土城區柑林里,761,433,162,124,39,99,160,1778,18,1796,2616,68.69499969
6501300-004,土城區員仁里,1372,892,246,206,64,84,221,3085,64,3149,4779,65.88750076
6501300-003,土城區員林里,1374,886,238,216,86,156,283,3239,44,3283,4899,67.08500099
6501300-037,土城區員信里,1062,726,181,160,54,96,235,2514,51,2565,3839,66.8700002
6501300-033,土城區員福里,1465,794,228,214,70,121,242,3134,48,3182,4800,66.23999977
6501300-017,土城區峯廷里,1953,1049,294,243,88,110,328,4065,59,4124,6408,64.30400085
6501300-026,土城區祖田里,522,227,59,62,19,24,77,990,13,1003,1439,69.69999695
6501300-010,土城區埤林里,2016,1363,345,358,150,210,413,4855,73,4928,7141,69.0780014
6501300-001,土城區埤塘里,941,564,156,109,44,71,158,2043,34,2077,4703,52.56666883
6501300-015,土城區清化里,456,208,70,48,23,43,74,922,19,941,1435,65.56999969
6501300-012,土城區清水里,2174,1159,304,306,103,168,325,4539,55,4594,6843,67.15800018
6501300-013,土城區清和里,1713,780,224,229,46,88,236,3316,38,3354,5382,62.39750004
6501300-016,土城區清溪里,1595,1180,277,222,82,172,295,3823,69,3892,5865,66.34749889
6501300-008,土城區貨饒里,1204,500,158,151,51,67,185,2316,36,2352,3486,67.45666758
6501300-023,土城區頂埔里,1110,784,198,154,50,89,230,2615,43,2658,4105,64.5600001
6501300-025,土城區頂新里,470,498,101,84,28,137,120,1438,19,1457,2153,67.77500153
6501300-024,土城區頂福里,1273,872,205,158,54,83,205,2850,71,2921,4336,67.24999746
6501300-035,土城區復興里,1231,690,182,204,87,96,214,2704,39,2743,3974,68.96666718
6501300-011,土城區瑞興里,943,394,136,138,44,51,149,1855,38,1893,2783,68.10499954
6501300-036,土城區裕生里,1532,755,216,182,57,113,255,3110,65,3175,4700,67.61499977
6501300-028,土城區廣福里,1316,931,210,254,117,165,284,3277,43,3320,4815,68.92666372
6501300-044,土城區廣興里,818,526,141,149,57,80,126,1897,22,1919,2860,67.10499954
6501300-027,土城區樂利里,1359,801,229,209,81,85,267,3031,41,3072,4584,67.00999959
6501300-042,土城區學士里,1117,674,192,174,98,128,243,2626,38,2664,3870,68.86666616
6501300-039,土城區學成里,985,506,120,155,46,77,165,2054,13,2067,2841,72.43999863
6501300-029,土城區學府里,935,546,118,126,61,69,170,2025,31,2056,3070,66.97500229
6500300-009,中和區力行里,1365,1073,254,212,108,253,292,3557,52,3609,5120,70.59666697
6500300-083,中和區中山里,737,480,113,90,43,99,155,1717,37,1754,2465,71.20999908
6500300-005,中和區中正里,985,704,163,137,33,113,215,2350,46,2396,3521,68.06000137
6500300-023,中和區中安里,727,892,175,95,58,314,448,2709,42,2751,3863,71.14333344
6500300-001,中和區中原里,1272,762,193,186,73,158,267,2911,52,2963,4464,66.49666595
6500300-081,中和區中興里,1276,1117,283,235,126,322,395,3754,44,3798,5625,67.55000114
6500300-004,中和區仁和里,1093,768,163,164,61,121,200,2570,54,2624,3729,70.58000183
6500300-042,中和區內南里,1007,1055,241,160,63,201,273,3000,78,3078,4475,68.77666728
6500300-059,中和區文元里,1513,823,181,202,68,132,360,3279,61,3340,4714,70.79000092
6500300-044,中和區外南里,895,768,189,141,69,181,240,2483,58,2541,6475,53.49666786
6500300-002,中和區平河里,2155,1530,384,324,120,313,425,5251,96,5347,7702,69.55399933
6500300-093,中和區正行里,638,522,146,110,48,124,153,1741,35,1776,2596,68.44499969
6500300-092,中和區正南里,629,775,141,93,24,161,221,2044,46,2090,3166,66.12000275
6500300-068,中和區民生里,1123,722,165,187,77,129,231,2634,40,2674,3779,70.7650032
6500300-061,中和區民安里,1310,745,195,190,74,119,246,2879,55,2934,4276,68.65333303
6500300-087,中和區民有里,758,486,142,92,35,71,153,1737,29,1766,2477,71.27999878
6500300-056,中和區民享里,809,427,115,107,39,61,104,1662,32,1694,2255,75.06999969
6500300-017,中和區瓦磘里,1209,876,194,199,84,224,275,3061,53,3114,4687,66.47666677
6500300-082,中和區吉興里,565,569,117,120,66,134,153,1724,28,1752,2593,67.54500198
6500300-022,中和區安平里,988,1254,284,230,132,373,346,3607,71,3678,5116,71.91666667
6500300-021,中和區安和里,635,628,150,93,55,165,164,1890,44,1934,2706,71.45000076
6500300-075,中和區安順里,835,943,158,160,83,257,280,2716,40,2756,3888,70.88500214
6500300-020,中和區安樂里,641,745,154,111,78,223,199,2151,45,2196,3182,68.86499786
6500300-062,中和區安穗里,1206,722,143,201,60,113,192,2637,57,2694,3927,68.73000081
6500300-054,中和區灰磘里,218,109,31,25,5,14,41,443,8,451,653,69.06999969
6500300-066,中和區自強里,1404,771,188,183,78,127,236,2987,47,3034,4387,68.99000295
6500300-077,中和區秀士里,416,513,125,75,36,122,142,1429,15,1444,2190,65.93500137
6500300-027,中和區秀山里,965,869,177,163,61,219,238,2692,61,2753,4004,68.76333364
6500300-033,中和區秀仁里,625,626,125,103,58,138,205,1880,22,1902,2796,68.02999878
6500300-072,中和區秀水里,646,835,172,113,50,192,199,2207,35,2242,3302,67.90333049
6500300-028,中和區秀成里,743,614,164,118,60,210,189,2098,25,2123,3098,68.49000168
6500300-031,中和區秀明里,721,1044,239,138,90,336,266,2834,38,2872,4333,66.39000066
6500300-032,中和區秀峰里,670,862,187,125,51,280,223,2398,45,2443,3545,68.8666687
6500300-030,中和區秀景里,1183,1245,259,198,102,361,347,3695,57,3752,5532,68.21749878
6500300-076,中和區秀義里,595,517,134,96,51,110,139,1642,32,1674,2348,71.15999985
6500300-029,中和區秀福里,1029,926,191,159,97,223,250,2875,48,2923,4227,69.15333303
6500300-019,中和區佳和里,1158,881,185,161,82,173,234,2874,63,2937,4177,70.52333323
6500300-046,中和區和興里,829,819,189,147,52,181,278,2495,47,2542,3726,67.98000336
6500300-074,中和區宜安里,343,361,87,54,32,96,133,1106,20,1126,1628,69.16000366
6500300-038,中和區忠孝里,786,1139,207,132,66,228,256,2814,68,2882,4318,66.96000004
6500300-071,中和區明德里,1019,658,163,125,46,78,171,2260,39,2299,3374,68.14999898
6500300-064,中和區明穗里,1240,708,172,197,101,129,256,2803,53,2856,3951,72.70999908
6500300-036,中和區東南里,471,1143,174,104,64,343,270,2569,48,2617,3825,68.23666636
6500300-010,中和區枋寮里,851,667,147,122,69,140,194,2190,38,2228,3168,70.35499954
6500300-003,中和區信和里,1140,678,176,141,64,95,218,2512,72,2584,3735,69.10000102
6500300-090,中和區冠穗里,910,591,143,190,55,102,204,2195,32,2227,3059,72.89999771
6500300-026,中和區南山里,1069,1013,176,196,104,251,282,3091,51,3142,4478,69.94999695
6500300-006,中和區建和里,721,819,159,123,38,182,184,2226,33,2259,3185,71.30333201
6500300-057,中和區員山里,1447,915,249,260,77,189,311,3448,99,3547,5203,68.45333354
6500300-088,中和區員富里,887,439,131,132,35,82,190,1896,34,1930,2910,66.40999985
6500300-024,中和區泰安里,781,641,145,109,52,174,235,2137,33,2170,3147,68.95333354
6500300-069,中和區國光里,1042,635,165,164,50,119,203,2378,50,2428,3396,71.52999878
6500300-091,中和區國華里,892,547,133,135,42,79,169,1997,33,2030,2892,69.93500137
6500300-039,中和區崇南里,652,913,182,133,77,226,228,2411,45,2456,3558,69.02500153
6500300-065,中和區清穗里,859,523,132,112,39,89,146,1900,38,1938,2818,68.76499939
6500300-007,中和區連和里,401,502,104,81,43,117,117,1365,28,1393,2102,66.30999756
6500300-008,中和區連城里,1334,1220,257,233,89,318,326,3777,59,3836,5539,69.25000254
6500300-034,中和區頂南里,538,658,140,86,61,234,200,1917,33,1950,2742,71.09499741
6500300-045,中和區復興里,1053,1023,200,182,62,219,331,3070,71,3141,4465,70.45666504
6500300-051,中和區景文里,705,605,145,125,50,157,197,1984,27,2011,2825,70.97999954
6500300-047,中和區景平里,974,1130,238,167,118,294,311,3232,63,3295,4836,68.32666524
6500300-079,中和區景本里,497,432,86,83,25,120,130,1373,29,1402,1935,72.50500107
6500300-050,中和區景安里,939,964,222,182,96,250,273,2926,61,2987,4169,71.71249962
6500300-040,中和區景南里,595,658,136,105,40,181,181,1896,40,1936,2836,68.23999786
6500300-048,中和區景新里,760,788,136,110,57,150,177,2178,42,2220,3216,69.00499725
6500300-049,中和區景福里,1059,1047,241,164,104,292,317,3224,64,3288,4774,69.03666941
6500300-037,中和區華南里,846,1084,216,139,79,239,276,2879,47,2926,4334,67.45666758
6500300-035,中和區華新里,1114,1462,323,183,87,350,363,3882,77,3959,6135,64.39249992
6500300-025,中和區新南里,1530,1553,350,274,165,378,406,4656,65,4721,6833,69.14500046
6500300-063,中和區瑞穗里,538,507,99,90,32,78,117,1461,28,1489,2064,72.18999863
6500300-060,中和區嘉新里,1030,652,146,144,56,94,178,2300,45,2345,3422,68.49000168
6500300-089,中和區嘉慶里,1085,653,179,174,67,125,209,2492,53,2545,3764,67.58666738
6500300-058,中和區嘉穗里,663,442,119,103,41,72,110,1550,39,1589,2322,68.25999832
6500300-043,中和區壽南里,537,463,91,70,39,112,131,1443,39,1482,2106,69.69499969
6500300-070,中和區壽德里,743,1003,217,105,64,264,232,2628,68,2696,3821,70.53999837
6500300-011,中和區漳和里,788,603,155,134,74,142,174,2070,41,2111,3055,69.06500244
6500300-084,中和區碧河里,1024,661,171,172,59,121,176,2384,49,2433,3506,69.41999817
6500300-018,中和區福和里,906,676,136,127,62,124,188,2219,40,2259,3259,69.1866684
6500300-080,中和區福南里,696,899,158,136,67,241,243,2440,61,2501,3710,67.41500092
6500300-015,中和區福美里,1095,843,186,152,66,175,199,2716,62,2778,3916,70.8100001
6500300-013,中和區福真里,1086,671,139,135,62,136,219,2448,38,2486,3619,68.70500183
6500300-016,中和區福祥里,1345,878,225,182,82,173,250,3135,61,3196,4467,71.91999817
6500300-014,中和區福善里,1015,735,183,158,64,186,196,2537,64,2601,3778,68.74333191
6500300-012,中和區廟美里,1061,790,196,157,77,148,214,2643,39,2682,3850,69.70666758
6500300-073,中和區德行里,1287,1162,280,250,137,283,333,3732,48,3780,5505,68.6933314
6500300-067,中和區德穗里,1096,872,196,170,68,145,210,2757,42,2799,3968,70.52999878
6500300-041,中和區橫路里,103,66,16,12,4,7,15,223,10,233,329,70.81999969
6500300-055,中和區積穗里,1933,1409,352,310,131,280,393,4808,96,4904,7012,70.18000158
6500300-078,中和區興南里,624,638,165,94,49,155,194,1919,56,1975,2852,69.24499893
6500300-085,中和區錦中里,974,643,175,160,57,138,222,2369,45,2414,3513,68.67333221
6500300-052,中和區錦和里,1258,879,240,185,81,193,285,3121,48,3169,4564,69.33666484
6500300-053,中和區錦昌里,468,439,96,95,35,110,116,1359,19,1378,1965,70.12999725
6500300-086,中和區錦盛里,997,588,143,165,51,125,171,2240,47,2287,3336,68.54499817
6501500-008,五股區五股里,1113,502,153,130,51,64,219,2232,52,2284,3723,61.67666753
6501500-009,五股區五福里,1046,488,128,130,45,61,179,2077,36,2113,3056,69.19000244
6501500-007,五股區五龍里,549,128,37,42,21,14,69,860,14,874,1262,69.26000214
6501500-015,五股區六福里,857,567,183,119,38,77,200,2041,25,2066,3121,66.19500351
6501500-019,五股區水碓里,2018,973,280,298,89,136,344,4138,55,4193,6390,65.59250069
6501500-017,五股區民義里,889,508,141,101,38,64,159,1900,33,1933,2826,68.40999985
6501500-006,五股區成功里,1579,565,198,178,57,77,253,2907,53,2960,4641,63.75
6501500-005,五股區成州里,1707,645,231,201,52,79,269,3184,53,3237,4905,66.00666809
6501500-018,五股區成泰里,1712,683,250,210,41,95,263,3254,68,3322,5261,63.43666712
6501500-014,五股區成德里,892,336,109,100,33,26,141,1637,38,1675,2499,67.02999878
6501500-002,五股區更寮里,499,101,44,36,12,12,66,770,13,783,1085,72.16999817
6501500-011,五股區陸一里,169,920,99,29,20,134,79,1450,33,1483,2062,71.92499924
6501500-012,五股區貿商里,391,769,186,63,32,157,114,1712,47,1759,2510,70.09000015
6501500-003,五股區集福里,1076,501,136,126,42,67,186,2134,36,2170,3254,67.32666779
6501500-016,五股區集賢里,1100,486,125,133,34,36,205,2119,43,2162,3176,68.10499954
6501500-020,五股區福德里,749,428,148,114,22,56,125,1642,26,1668,2568,65.20499992
6501500-010,五股區德音里,1326,726,246,175,60,120,250,2903,44,2947,4283,68.8133316
6501500-013,五股區德泰里,1057,621,221,161,45,62,181,2348,54,2402,3624,66.25666555
6501500-001,五股區興珍里,1669,501,170,227,49,64,220,2900,45,2945,4247,69.42000071
6501500-004,五股區觀音里,514,175,43,47,10,8,60,857,12,869,1271,68.37000275
6502400-011,平溪區十分里,222,144,25,11,5,11,50,468,24,492,835,58.91999817
6502400-010,平溪區平湖里,50,30,6,5,0,5,9,105,2,107,171,62.56999969
6502400-005,平溪區平溪里,51,58,11,4,3,2,14,143,7,150,243,61.72999954
6502400-003,平溪區白石里,82,38,16,6,7,4,12,165,4,169,247,68.41999817
6502400-004,平溪區石底里,153,77,19,6,4,2,33,294,16,310,445,69.66000366
6502400-007,平溪區東勢里,131,78,27,12,0,4,25,277,7,284,443,64.11000061
6502400-009,平溪區南山里,106,53,14,6,3,1,32,215,6,221,386,57.25
6502400-008,平溪區望古里,44,29,10,9,3,3,8,106,3,109,157,69.43000031
6502400-002,平溪區菁桐里,62,48,14,2,4,5,13,148,3,151,257,58.75
6502400-012,平溪區新寮里,40,27,6,1,1,1,10,86,3,89,159,55.97000122
6502400-006,平溪區嶺腳里,176,120,26,10,2,6,35,375,12,387,649,59.63000107
6502400-001,平溪區薯榔里,150,60,18,11,3,3,22,267,1,268,404,66.33999634
6500400-051,永和區上林里,505,768,120,111,82,201,210,1997,29,2026,3003,67.41500092
6500400-022,永和區上溪里,389,382,70,69,34,119,98,1161,17,1178,1786,65.84000015
6500400-046,永和區下溪里,806,707,164,144,57,169,238,2285,31,2316,3390,68.38999939
6500400-042,永和區大同里,123,230,57,14,11,73,55,563,27,590,858,68.76000214
6500400-032,永和區大新里,474,534,108,90,50,162,168,1586,29,1615,2302,70.35000229
6500400-014,永和區中溪里,1041,874,212,178,106,231,274,2916,40,2956,4340,68.12666575
6500400-018,永和區中興里,566,498,108,78,42,163,214,1669,20,1689,2580,65.61000061
6500400-005,永和區仁愛里,520,517,108,88,44,143,157,1577,23,1600,2315,69.10499954
6500400-002,永和區文化里,469,564,121,84,56,167,167,1628,39,1667,2391,69.72999954
6500400-026,永和區水源里,745,774,166,126,86,261,247,2405,38,2443,3522,69.3799998
6500400-053,永和區正興里,405,440,76,57,36,135,146,1295,19,1314,1994,65.93999863
6500400-034,永和區民本里,761,682,137,121,77,176,201,2155,31,2186,3340,65.44499969
6500400-049,永和區民生里,825,793,170,113,71,191,207,2370,31,2401,3421,70.1200002
6500400-008,永和區民治里,500,595,104,84,44,137,152,1616,32,1648,2531,65.11500168
6500400-016,永和區民族里,789,909,202,169,78,295,220,2662,35,2697,3964,68.19666545
6500400-059,永和區民富里,612,552,120,114,49,120,152,1719,24,1743,2522,69.15499878
6500400-035,永和區民樂里,821,989,183,134,92,292,251,2762,39,2801,4034,69.44333394
6500400-017,永和區民權里,797,832,149,138,79,281,230,2506,38,2544,3836,66.28333282
6500400-011,永和區永元里,920,937,196,172,103,219,254,2801,36,2837,4095,69.27333577
6500400-015,永和區永安里,721,859,171,139,94,269,216,2469,33,2502,3542,70.68000031
6500400-009,永和區永成里,75,250,63,19,12,79,73,571,22,593,919,64.52999878
6500400-006,永和區永貞里,685,669,102,113,85,183,192,2029,34,2063,3016,68.38499832
6500400-007,永和區永福里,520,528,124,113,61,185,183,1714,25,1739,2434,71.39500046
6500400-061,永和區永樂里,511,411,110,77,44,102,131,1386,15,1401,2118,66.13000107
6500400-054,永和區永興里,560,613,114,105,53,193,177,1815,32,1847,2809,65.75999832
6500400-004,永和區光明里,564,644,109,114,77,198,159,1865,28,1893,2647,71.61000061
6500400-036,永和區光復里,277,347,73,55,44,103,101,1000,22,1022,1483,68.91000366
6500400-025,永和區安和里,693,774,161,127,75,267,223,2320,26,2346,3457,67.96500015
6500400-023,永和區竹林里,693,737,143,137,66,200,195,2171,43,2214,3256,68.00500107
6500400-060,永和區秀元里,632,583,105,86,56,171,188,1821,26,1847,2660,69.46999741
6500400-021,永和區秀成里,612,543,113,103,62,157,164,1754,24,1778,2565,69.35499954
6500400-047,永和區秀和里,971,943,184,178,116,245,303,2940,41,2981,4279,69.71333567
6500400-012,永和區秀林里,857,711,135,142,68,156,190,2259,25,2284,3155,72.43999863
6500400-020,永和區秀朗里,826,687,169,120,65,212,246,2325,36,2361,3413,69.18000031
6500400-050,永和區秀得里,500,540,111,84,51,129,138,1553,21,1574,2309,68.11999893
6500400-027,永和區協和里,580,556,119,78,52,141,167,1693,32,1725,2516,68.54999924
6500400-044,永和區和平里,973,910,176,160,87,254,244,2804,45,2849,4173,68.2533315
6500400-056,永和區店街里,738,736,154,119,65,263,258,2333,34,2367,3571,66.27000046
6500400-010,永和區忠義里,65,182,50,19,5,95,59,475,20,495,714,69.33000183
6500400-028,永和區河堤里,554,558,107,100,89,191,183,1782,23,1805,2773,65.26499939
6500400-048,永和區河濱里,570,655,128,115,70,189,166,1893,32,1925,2819,68.74000168
6500400-033,永和區保平里,1066,839,198,173,90,216,270,2852,52,2904,4108,70.44666799
6500400-013,永和區保安里,1409,1339,268,261,143,365,391,4176,44,4220,6052,69.73749924
6500400-062,永和區保順里,1663,1780,413,350,205,559,480,5450,50,5500,8221,66.74714334
6500400-057,永和區信義里,523,528,88,92,56,160,152,1599,25,1624,2370,68.63000107
6500400-043,永和區前溪里,372,375,85,63,39,133,126,1193,17,1210,1826,66.26999664
6500400-058,永和區後溪里,428,341,69,93,31,75,98,1135,10,1145,1640,69.81999969
6500400-055,永和區桂林里,565,738,163,92,66,218,219,2061,36,2097,3162,66.25499725
6500400-039,永和區得和里,749,882,165,152,86,289,258,2581,39,2620,3754,69.71000163
6500400-029,永和區頂溪里,524,515,118,90,52,140,137,1576,24,1600,2212,72.23999786
6500400-037,永和區復興里,410,506,83,77,37,169,155,1437,29,1466,2095,69.82499695
6500400-040,永和區智光里,618,623,166,97,58,148,160,1870,26,1896,2872,66.04000092
6500400-041,永和區新生里,134,163,40,17,11,55,69,489,9,498,775,64.26000214
6500400-045,永和區新廍里,434,479,83,79,47,148,140,1410,21,1431,2020,70.85000229
6500400-038,永和區福和里,925,986,181,177,124,339,280,3012,24,3036,4533,66.97333527
6500400-001,永和區福林里,671,667,136,115,50,200,189,2028,25,2053,2959,69.39999771
6500400-052,永和區網溪里,219,239,59,23,24,57,68,689,10,699,1030,67.86000061
6500400-031,永和區潭安里,791,1004,179,166,80,261,272,2753,39,2792,4151,67.16499996
6500400-030,永和區潭墘里,730,903,180,141,81,295,264,2594,34,2628,3822,68.88666789
6500400-003,永和區豫溪里,649,718,134,122,76,238,197,2134,32,2166,4403,53.82999992
6500400-019,永和區勵行里,288,181,43,35,28,57,75,707,21,728,1090,66.79000092
6500400-024,永和區雙和里,730,691,172,127,71,238,237,2266,30,2296,3340,68.80500031
6502200-004,石門區山溪里,198,125,24,14,3,6,145,515,10,525,854,61.47999954
6502200-005,石門區石門里,334,289,43,37,18,25,190,936,23,959,1474,65.05999756
6502200-006,石門區尖鹿里,338,279,27,37,6,9,157,853,31,884,1461,60.50999832
6502200-003,石門區老梅里,481,313,44,54,30,28,284,1234,48,1282,2114,60.64999962
6502200-008,石門區茂林里,152,103,21,9,4,20,57,366,10,376,663,56.70999908
6502200-009,石門區草里里,192,191,22,17,7,13,77,519,12,531,901,58.93000031
6502200-007,石門區乾華里,67,60,7,15,6,4,59,218,11,229,344,66.56999969
6502200-002,石門區富基里,345,248,33,31,13,20,148,838,19,857,1359,63.06000137
6502200-001,石門區德茂里,288,174,31,30,9,13,103,648,22,670,1107,60.52000046
6501900-008,石碇區中民里,234,94,40,17,6,13,56,460,17,477,704,67.76000214
6501900-011,石碇區永安里,245,104,29,25,8,7,26,444,9,453,709,63.88999939
6501900-007,石碇區永定里,194,80,16,12,2,5,30,339,10,349,567,61.54999924
6501900-001,石碇區石碇里,156,72,12,17,5,1,9,272,9,281,397,70.77999878
6501900-009,石碇區光明里,100,25,10,7,2,8,15,167,4,171,243,70.37000275
6501900-012,石碇區格頭里,347,119,34,19,15,12,54,600,9,609,872,69.83999634
6501900-004,石碇區烏塗里,285,81,17,21,10,16,35,465,21,486,699,69.52999878
6501900-005,石碇區彭山里,86,53,13,6,0,7,20,185,11,196,315,62.22000122
6501900-003,石碇區隆盛里,217,106,27,13,13,9,39,424,11,435,676,64.34999847
6501900-002,石碇區潭邊里,242,130,24,22,4,15,47,484,12,496,749,66.22000122
6501900-006,石碇區豐田里,136,82,15,10,0,6,26,275,8,283,392,72.36000061
6501900-010,石碇區豐林里,95,58,8,2,3,5,21,192,4,196,273,71.79000092
6501100-017,汐止區八連里,301,141,27,35,11,23,36,574,6,580,930,62.36999893
6501100-041,汐止區大同里,569,462,102,119,31,91,133,1507,28,1535,2368,64.82500076
6501100-040,汐止區山光里,478,486,144,56,30,73,102,1369,34,1403,2295,61.13999939
6501100-026,汐止區中興里,1735,1129,260,269,70,186,251,3900,60,3960,6272,63.12249947
6501100-028,汐止區仁德里,400,312,59,76,17,52,89,1005,24,1029,1515,67.91999817
6501100-032,汐止區文化里,939,681,168,165,56,118,205,2332,54,2386,3623,65.84499741
6501100-020,汐止區北山里,1327,934,195,197,68,189,266,3176,39,3215,4747,67.59499931
6501100-019,汐止區北峰里,1186,563,166,169,59,101,195,2439,40,2479,3855,64.29500008
6501100-021,汐止區白雲里,952,665,143,184,44,145,184,2317,45,2362,3576,66.04999924
6501100-014,汐止區江北里,1381,889,239,188,60,131,281,3169,55,3224,5043,64.09000015
6501100-031,汐止區自強里,1150,707,195,161,67,114,230,2624,47,2671,4158,64.18333435
6501100-046,汐止區秀山里,888,687,168,164,80,178,198,2363,29,2392,3575,67.00499725
6501100-006,汐止區秀峰里,981,613,152,145,59,85,183,2218,37,2255,4534,51.11666616
6501100-025,汐止區宜興里,601,565,136,77,58,162,157,1756,38,1794,2603,68.84999847
6501100-037,汐止區忠山里,640,672,131,102,84,285,200,2114,24,2138,3070,69.60000229
6501100-030,汐止區忠孝里,1598,1329,300,258,109,257,332,4183,69,4252,6512,65.27999878
6501100-023,汐止區東山里,151,77,20,24,6,13,29,320,7,327,496,65.93000031
6501100-039,汐止區東勢里,831,700,134,162,72,253,204,2356,23,2379,3555,66.6299998
6501100-033,汐止區金龍里,1061,664,205,159,66,151,218,2524,54,2578,4210,61.22333272
6501100-010,汐止區長安里,458,237,55,54,13,62,74,953,22,975,1442,67.61000061
6501100-044,汐止區長青里,208,181,50,23,22,59,53,596,17,613,904,67.80999756
6501100-011,汐止區保安里,404,255,57,43,16,31,66,872,18,890,1390,64.02999878
6501100-012,汐止區保長里,934,521,181,140,44,101,258,2179,38,2217,3476,63.7650013
6501100-050,汐止區保新里,529,413,129,85,36,137,138,1467,28,1495,2471,62.26000023
6501100-004,汐止區信望里,82,43,15,8,9,8,19,184,5,189,302,62.58000183
6501100-029,汐止區厚德里,1421,1265,337,231,89,228,327,3898,71,3969,6229,63.73750019
6501100-048,汐止區城中里,910,725,212,158,57,185,193,2440,37,2477,3703,66.91999817
6501100-047,汐止區建成里,1006,859,223,157,62,208,236,2751,50,2801,4146,67.52999878
6501100-015,汐止區拱北里,1080,689,208,136,41,133,195,2482,37,2519,4292,58.63333257
6501100-009,汐止區茄苳里,1002,647,161,129,51,91,204,2285,56,2341,3825,61.20666631
6501100-016,汐止區烘內里,431,257,65,43,13,54,60,923,15,938,1427,65.73000336
6501100-042,汐止區崇德里,1122,703,182,188,66,154,226,2641,51,2692,4089,65.85999807
6501100-036,汐止區康福里,1045,823,246,206,71,176,212,2779,61,2840,4406,64.56666946
6501100-008,汐止區復興里,1487,1183,284,252,140,304,300,3950,67,4017,5774,69.62666829
6501100-003,汐止區智慧里,875,779,143,151,73,241,204,2466,32,2498,3825,65.29000092
6501100-027,汐止區湖光里,1140,955,248,186,80,252,203,3064,72,3136,4843,64.6299998
6501100-049,汐止區湖蓮里,398,484,108,127,65,192,112,1486,18,1504,2257,66.57999802
6501100-043,汐止區湖興里,1183,1097,286,191,92,381,286,3516,55,3571,5375,66.58000183
6501100-013,汐止區鄉長里,583,359,96,78,36,59,124,1335,29,1364,2006,68
6501100-007,汐止區新昌里,1303,875,204,218,62,134,263,3059,44,3103,4562,68.00666555
6501100-001,汐止區義民里,312,252,57,37,26,34,69,787,18,805,1246,64.61000061
6501100-024,汐止區福山里,753,584,120,118,88,197,197,2057,28,2085,3141,66.45000076
6501100-045,汐止區福安里,1255,882,195,244,62,133,233,3004,44,3048,4588,66.4399999
6501100-034,汐止區福德里,756,474,120,97,36,86,108,1677,42,1719,2765,62.125
6501100-018,汐止區樟樹里,574,322,91,85,24,58,91,1245,21,1266,1954,64.79000092
6501100-005,汐止區橋東里,634,432,108,107,34,79,114,1508,21,1529,2343,65.26000214
6501100-022,汐止區橫科里,1073,762,169,173,79,171,209,2636,51,2687,4055,66.22499847
6501100-035,汐止區興福里,655,496,128,106,29,116,133,1663,28,1691,2596,65.16500092
6501100-038,汐止區環河里,413,167,34,36,8,16,66,740,15,755,1107,68.19999695
6501100-002,汐止區禮門里,277,155,42,45,12,13,58,602,12,614,915,67.09999847
6502000-005,坪林區上德里,249,137,36,23,9,12,43,509,9,518,761,68.86000061
6502000-003,坪林區大林里,384,127,33,35,10,9,65,663,15,678,1068,63.47999954
6502000-006,坪林區水德里,209,91,16,12,2,3,60,393,8,401,593,67.62000275
6502000-004,坪林區石𥕢里,148,42,25,4,2,6,23,250,9,259,409,63.33000183
6502000-002,坪林區坪林里,416,177,33,40,23,23,58,770,20,790,1122,70.41000366
6502000-001,坪林區粗窟里,300,146,30,14,10,6,36,542,19,561,817,70.06999969
6502000-007,坪林區漁光里,329,91,22,11,1,4,32,490,20,510,807,63.34000015
6500100-058,板橋區九如里,874,405,110,109,36,46,134,1714,33,1747,2431,71.84000015
6500100-094,板橋區大安里,1097,622,204,156,42,88,273,2482,50,2532,3609,70.15333303
6500100-079,板橋區大豐里,1223,798,208,154,74,120,224,2801,53,2854,3991,71.57999929
6500100-125,板橋區大觀里,1164,498,136,142,55,56,175,2226,29,2255,3185,70.79999924
6500100-092,板橋區中山里,1043,572,163,145,37,84,202,2246,55,2301,3437,67.15333303
6500100-010,板橋區中正里,1163,642,149,194,55,94,196,2493,51,2544,3720,68.39666494
6500100-123,板橋區五權里,1215,628,181,143,52,99,219,2537,32,2569,3601,71.32666779
6500100-081,板橋區仁愛里,642,708,152,125,50,108,178,1963,43,2006,2742,73.1899999
6500100-034,板橋區仁翠里,978,351,100,83,28,46,144,1730,40,1770,2574,68.82999802
6500100-026,板橋區介壽里,827,481,109,111,42,59,158,1787,27,1814,2596,69.84000015
6500100-021,板橋區公舘里,1104,569,156,129,54,86,215,2313,33,2346,3298,71.13000234
6500100-104,板橋區文化里,955,495,122,131,57,91,172,2023,23,2046,2838,72.03499985
6500100-119,板橋區文聖里,1152,525,130,131,49,81,167,2235,31,2266,3331,68.02499771
6500100-046,板橋區文翠里,1119,589,144,153,81,83,208,2377,38,2415,3515,68.67333221
6500100-103,板橋區文德里,867,491,100,144,51,78,147,1878,23,1901,2653,71.70000076
6500100-108,板橋區正泰里,918,451,123,132,50,61,170,1905,22,1927,2626,73.69499969
6500100-109,板橋區民生里,699,304,77,79,44,49,108,1360,21,1381,1967,70.10000229
6500100-115,板橋區民安里,528,392,67,88,23,74,98,1270,13,1283,1798,71.32500076
6500100-072,板橋區民族里,1120,674,135,161,86,121,219,2516,41,2557,3646,70.18000031
6500100-018,板橋區民權里,677,527,86,92,52,95,135,1664,36,1700,2318,73.32500076
6500100-062,板橋區永安里,1019,537,116,130,47,49,162,2060,28,2088,2952,70.56999969
6500100-059,板橋區玉光里,1394,731,193,209,64,114,285,2990,48,3038,4396,69.07333374
6500100-060,板橋區光仁里,842,402,118,118,42,71,165,1758,30,1788,2472,72.32999802
6500100-053,板橋區光復里,952,471,126,128,51,95,132,1955,19,1974,2814,70.15999985
6500100-013,板橋區光華里,676,501,91,99,49,91,160,1667,26,1693,2348,72.01000214
6500100-114,板橋區光榮里,629,447,95,90,49,90,136,1536,18,1554,2270,68.45499802
6500100-036,板橋區吉翠里,1191,515,145,142,46,72,204,2315,52,2367,3243,72.99000041
6500100-113,板橋區成和里,1549,803,285,214,69,112,293,3325,62,3387,5172,65.52333196
6500100-029,板橋區江翠里,1417,687,147,183,46,96,218,2794,33,2827,4084,69.19999949
6500100-025,板橋區百壽里,646,367,93,78,30,54,121,1389,21,1410,1978,71.26000214
6500100-012,板橋區自立里,794,435,95,116,32,60,153,1685,35,1720,2434,70.65499878
6500100-011,板橋區自強里,1135,1039,200,233,125,259,270,3261,41,3302,4546,72.64750099
6500100-067,板橋區西安里,742,431,90,104,33,59,120,1579,28,1607,2301,69.88999939
6500100-033,板橋區宏翠里,1256,670,161,200,63,108,242,2700,40,2740,4119,66.61000061
6500100-003,板橋區赤松里,184,132,29,24,17,17,43,446,8,454,640,70.94000244
6500100-082,板橋區和平里,788,606,176,163,52,115,207,2107,25,2132,3015,70.68500137
6500100-120,板橋區居仁里,992,495,129,162,48,67,143,2036,27,2063,2876,71.70000076
6500100-023,板橋區幸福里,1108,582,168,151,47,79,194,2329,46,2375,3415,69.43333435
6500100-024,板橋區忠誠里,583,1060,151,128,60,286,192,2460,30,2490,3460,71.96666718
6500100-044,板橋區忠翠里,2426,1656,333,420,194,336,530,5895,76,5971,8300,71.97799988
6500100-039,板橋區明翠里,1476,761,158,213,65,88,264,3025,39,3064,4298,71.16250038
6500100-068,板橋區東丘里,1422,658,152,149,58,62,246,2747,38,2785,3918,71.0600001
6500100-122,板橋區東安里,745,317,92,93,27,48,92,1414,17,1431,2067,69.20000076
6500100-118,板橋區松柏里,667,343,77,84,24,62,133,1390,27,1417,2002,70.8599968
6500100-040,板橋區松翠里,994,495,107,109,37,108,162,2012,38,2050,2938,69.72499847
6500100-008,板橋區社後里,1652,966,204,198,98,132,320,3570,49,3619,8059,58.92999935
6500100-016,板橋區金華里,1149,590,129,141,45,87,174,2315,41,2356,3411,69.05666606
6500100-069,板橋區長安里,1248,690,149,174,63,123,193,2640,47,2687,3713,72.49000041
6500100-055,板橋區長壽里,833,426,87,127,29,79,145,1726,34,1760,2465,71.52500153
6500100-047,板橋區青翠里,893,370,115,100,56,55,145,1734,35,1769,2658,66.58000183
6500100-088,板橋區信義里,1097,682,164,114,30,86,202,2375,57,2432,3618,67.3700002
6500100-019,板橋區建國里,1096,546,133,151,51,81,176,2234,46,2280,3167,71.99333445
6500100-110,板橋區後埔里,941,657,144,150,75,112,199,2278,27,2305,3301,69.84500122
6500100-041,板橋區柏翠里,1100,576,153,131,69,111,194,2334,34,2368,3461,68.42000198
6500100-002,板橋區流芳里,382,237,53,63,19,30,85,869,16,885,1261,70.18000031
6500100-080,板橋區重慶里,2174,1381,352,305,120,223,413,4968,60,5028,7428,67.73200073
6500100-066,板橋區香丘里,1022,558,120,151,59,98,186,2194,35,2229,3161,70.50999959
6500100-009,板橋區香社里,1274,630,151,176,62,72,199,2564,41,2605,3737,69.58666484
6500100-101,板橋區香雅里,749,397,89,99,38,64,143,1579,21,1600,2280,70.24499893
6500100-054,板橋區埔墘里,1759,1030,207,223,88,149,305,3761,55,3816,5390,70.62750053
6500100-052,板橋區振義里,1352,564,136,147,62,82,199,2542,45,2587,3636,71.09999847
6500100-051,板橋區振興里,1406,695,165,164,67,90,233,2820,30,2850,3898,73.15666707
6500100-005,板橋區挹秀里,337,363,56,57,32,57,104,1006,13,1019,1447,70.3599968
6500100-089,板橋區浮洲里,1170,448,164,163,54,66,176,2241,36,2277,3580,63.06666565
6500100-057,板橋區海山里,1910,1113,294,288,125,227,378,4335,54,4389,6167,70.94199982
6500100-001,板橋區留侯里,339,270,78,60,20,47,101,915,20,935,1341,69.72000122
6500100-030,板橋區純翠里,1640,756,187,200,86,108,245,3222,49,3271,4670,70.07999929
6500100-014,板橋區國光里,564,950,184,129,68,301,187,2383,28,2411,3317,72.6866684
6500100-073,板橋區國泰里,867,632,149,134,54,100,175,2111,28,2139,3027,70.61999893
6500100-061,板橋區埤墘里,1163,571,160,152,68,96,224,2434,26,2460,3532,69.65999985
6500100-112,板橋區堂春里,1176,599,177,162,50,79,208,2451,40,2491,3632,68.57500076
6500100-098,板橋區崑崙里,2512,1414,398,308,111,165,450,5358,77,5435,8039,67.60000153
6500100-065,板橋區深丘里,1851,1312,275,340,161,300,404,4643,66,4709,6921,68.14249802
6500100-121,板橋區莊敬里,1044,646,132,162,66,128,180,2358,30,2388,3327,71.79999924
6500100-106,板橋區莒光里,909,406,87,123,43,60,137,1765,16,1781,2491,71.53499985
6500100-107,板橋區富貴里,652,385,76,89,39,62,123,1426,12,1438,1939,74.20500183
6500100-045,板橋區嵐翠里,808,373,91,96,36,34,115,1553,25,1578,2220,71.08499908
6500100-093,板橋區復興里,274,201,46,31,7,10,45,614,14,628,970,64.28000069
6500100-075,板橋區景星里,800,532,125,135,83,87,209,1971,24,1995,2927,68.1649971
6500100-117,板橋區朝陽里,1088,463,105,109,32,55,164,2016,29,2045,2947,69.30000051
6500100-015,板橋區港尾里,751,485,89,126,35,87,150,1723,30,1753,2405,72.88000107
6500100-050,板橋區港嘴里,1822,873,220,246,97,117,272,3647,42,3689,5381,68.68250084
6500100-017,板橋區港德里,1395,694,201,171,77,91,266,2895,56,2951,4242,69.48999977
6500100-006,板橋區湳興里,1361,888,188,240,78,109,291,3155,63,3218,4728,68.33499908
6500100-090,板橋區華中里,1682,695,197,185,62,67,284,3172,42,3214,4647,69.3233312
6500100-028,板橋區華江里,1719,1097,263,264,117,202,318,3980,46,4026,5812,69.60749817
6500100-087,板橋區華東里,1506,1273,284,290,128,282,356,4119,51,4170,5810,71.88333384
6500100-085,板橋區華貴里,744,455,120,93,36,64,127,1639,30,1669,2333,71.47999954
6500100-111,板橋區華福里,558,395,81,80,30,61,123,1328,17,1345,1870,71.82999802
6500100-043,板橋區華翠里,1034,527,124,157,71,86,184,2183,25,2208,3076,71.80500031
6500100-086,板橋區華德里,1677,1175,271,266,108,167,309,3973,59,4032,6010,67.17000008
6500100-084,板橋區華興里,1040,698,157,158,68,89,195,2405,29,2434,3511,69.31999969
6500100-077,板橋區鄉雲里,952,627,133,155,55,105,187,2214,29,2243,3192,70.17000198
6500100-116,板橋區陽明里,854,460,78,126,48,67,146,1779,29,1808,2493,72.45500183
6500100-004,板橋區黃石里,302,160,41,37,20,28,53,641,12,653,925,70.58999634
6500100-022,板橋區新民里,1167,704,163,159,65,99,216,2573,41,2614,3662,71.34666697
6500100-102,板橋區新生里,1234,698,147,179,79,88,199,2624,31,2655,3769,70.48000081
6500100-027,板橋區新埔里,610,332,85,88,29,37,143,1324,20,1344,1887,71.15999985
6500100-105,板橋區新海里,1067,481,126,137,52,56,197,2116,35,2151,3115,69.03666433
6500100-035,板橋區新翠里,2118,1141,281,323,141,219,341,4564,48,4612,6615,69.74500084
6500100-007,板橋區新興里,764,501,136,122,55,72,159,1809,31,1840,2814,65.36499786
6500100-100,板橋區溪北里,950,561,162,132,37,50,224,2116,49,2165,3016,71.77500153
6500100-099,板橋區溪洲里,1588,888,209,218,74,93,269,3339,63,3402,5038,67.53666687
6500100-124,板橋區溪福里,3371,1881,527,473,172,258,586,7268,106,7374,11274,65.38666725
6500100-031,板橋區溪頭里,1742,799,210,202,77,129,285,3444,47,3491,5142,67.86999893
6500100-091,板橋區僑中里,1185,587,158,145,64,53,196,2388,42,2430,3500,69.3666687
6500100-038,板橋區滿翠里,1008,376,120,96,36,31,172,1839,31,1870,2640,70.77666728
6500100-020,板橋區漢生里,1084,743,142,155,78,170,224,2596,41,2637,3630,72.59666443
6500100-070,板橋區福丘里,964,811,182,148,68,186,222,2581,30,2611,3837,68.10499954
6500100-095,板橋區福安里,671,387,114,73,41,65,145,1496,37,1533,2292,66.88999939
6500100-076,板橋區福星里,916,619,114,123,75,72,192,2111,24,2135,2945,72.5
6500100-071,板橋區福祿里,800,692,150,127,68,130,198,2165,34,2199,3283,67.20000076
6500100-056,板橋區福壽里,827,556,139,129,60,90,162,1963,26,1989,2896,68.64500046
6500100-049,板橋區福翠里,352,211,58,49,13,47,76,806,29,835,1234,67.66999817
6500100-074,板橋區福德里,1410,891,179,203,79,109,257,3128,43,3171,4385,72.18000031
6500100-096,板橋區聚安里,1681,752,205,162,63,83,252,3198,46,3244,4713,68.78750038
6500100-064,板橋區廣新里,1022,503,134,123,27,71,149,2029,44,2073,3044,68.00666555
6500100-083,板橋區廣福里,1069,549,171,125,48,78,180,2220,34,2254,3437,65.58499908
6500100-078,板橋區廣德里,1644,1195,262,257,119,173,323,3973,64,4037,5660,71.22000122
6500100-037,板橋區德翠里,1898,1087,295,270,85,202,322,4159,51,4210,5955,70.88749886
6500100-097,板橋區龍安里,830,421,119,100,35,55,137,1697,35,1732,2482,69.7899971
6500100-042,板橋區龍翠里,1502,709,167,208,69,100,243,2998,38,3036,4335,70.03333282
6500100-032,板橋區聯翠里,900,549,121,141,57,116,199,2083,37,2120,3127,67.79000092
6500100-063,板橋區雙玉里,1095,537,137,155,54,74,192,2244,28,2272,3295,68.95000076
6500100-048,板橋區懷翠里,1804,781,193,196,69,94,282,3419,49,3468,5164,67.15333303
6500100-126,板橋區歡園里,414,188,51,41,14,14,84,806,23,829,1168,70.98000336
6501700-011,林口區下福里,368,244,53,34,16,12,77,804,21,825,1175,70.20999908
6501700-005,林口區中湖里,1040,535,136,130,40,61,160,2102,28,2130,3068,69.38000107
6501700-015,林口區仁愛里,1145,996,321,225,108,244,289,3328,35,3363,5174,64.89333344
6501700-014,林口區太平里,431,132,72,69,17,7,85,813,20,833,1297,64.23000336
6501700-003,林口區西林里,1993,1312,460,307,117,243,398,4830,60,4890,7360,66.27399826
6501700-001,林口區東林里,1151,568,176,123,44,55,192,2309,58,2367,3582,66.04000092
6501700-009,林口區東勢里,1289,972,291,203,99,202,330,3386,49,3435,5093,67.44666545
6501700-002,林口區林口里,1294,830,266,170,63,105,230,2958,41,2999,4578,65.62333171
6501700-008,林口區南勢里,2795,2165,671,528,222,657,618,7656,90,7746,12171,63.69428689
6501700-010,林口區頂福里,425,107,44,21,10,8,54,669,17,686,1016,67.51999664
6501700-006,林口區湖北里,540,183,63,52,15,16,80,949,21,970,1356,71.52999878
6501700-007,林口區湖南里,3322,2471,750,594,262,703,727,8829,104,8933,14006,64.07111104
6501700-004,林口區菁湖里,1188,652,175,155,64,122,188,2544,34,2578,3700,69.69333394
6501700-013,林口區瑞平里,297,107,29,30,8,6,39,516,21,537,788,68.15000153
6501700-012,林口區嘉寶里,353,127,27,24,10,7,43,591,17,608,853,71.27999878
6501700-016,林口區麗林里,1476,1349,423,290,113,283,341,4275,50,4325,6623,65.33499908
6501700-017,林口區麗園里,943,647,212,129,55,96,178,2260,34,2294,3435,66.73500061
6502700-010,金山區三界里,175,111,25,22,7,8,50,398,14,412,647,63.68000031
6502700-002,金山區大同里,159,121,30,31,4,11,52,408,6,414,705,58.72000122
6502700-006,金山區五湖里,440,296,59,83,17,29,149,1073,25,1098,1660,66.22500229
6502700-009,金山區六股里,204,96,9,23,3,11,60,406,13,419,637,65.77999878
6502700-014,金山區永興里,141,93,15,11,1,2,56,319,14,333,583,57.11999893
6502700-013,金山區西湖里,46,26,4,5,3,11,20,115,6,121,191,63.34999847
6502700-008,金山區兩湖里,116,72,14,5,2,5,24,238,8,246,368,66.84999847
6502700-001,金山區和平里,135,79,20,18,1,7,53,313,9,322,476,67.65000153
6502700-015,金山區金美里,1209,829,187,174,63,64,352,2878,55,2933,4759,61.53333282
6502700-005,金山區美田里,912,572,130,136,44,55,307,2156,50,2206,3543,62.31999969
6502700-007,金山區重和里,341,140,41,41,15,38,89,705,11,716,1203,59.52000046
6502700-011,金山區清泉里,215,129,25,27,8,8,71,483,15,498,808,61.63000107
6502700-012,金山區萬壽里,126,59,13,12,7,6,44,267,11,278,446,62.33000183
6502700-004,金山區磺港里,540,215,54,53,8,13,106,989,20,1009,1715,58.83000183
6502700-003,金山區豐漁里,161,76,17,7,5,11,23,300,6,306,495,61.81999969
6501600-001,泰山區大科里,278,96,64,29,5,8,30,510,15,525,799,65.03499794
6501600-003,泰山區山腳里,1638,914,379,219,63,117,263,3593,62,3655,5646,64.78000069
6501600-017,泰山區全興里,1940,1066,385,344,94,192,282,4303,53,4356,6874,63.43199921
6501600-006,泰山區同榮里,988,647,256,140,45,116,189,2381,38,2419,3460,69.87333425
6501600-011,泰山區同興里,1030,482,228,137,62,76,126,2141,35,2176,3119,69.74499893
6501600-008,泰山區明志里,1044,539,208,134,50,89,158,2222,44,2266,3211,70.58333588
6501600-013,泰山區泰友里,602,343,106,86,23,37,109,1306,27,1333,1956,68.13000107
6501600-009,泰山區貴子里,1050,582,156,159,52,74,203,2276,37,2313,3298,70.17333476
6501600-010,泰山區貴和里,1336,720,203,162,66,85,209,2781,34,2815,4220,66.76666768
6501600-015,泰山區貴賢里,971,629,230,146,54,93,137,2260,25,2285,3214,71.11000061
6501600-014,泰山區新明里,928,455,183,124,45,57,158,1950,37,1987,2876,69.09000015
6501600-005,泰山區楓樹里,1172,610,253,139,34,56,180,2444,36,2480,3724,66.5633316
6501600-012,泰山區義仁里,2147,1037,340,292,90,149,322,4377,58,4435,6633,66.84499741
6501600-007,泰山區義學里,1266,634,208,148,52,70,171,2549,27,2576,3767,68.23666636
6501600-004,泰山區福泰里,752,415,187,76,19,39,116,1604,27,1631,2427,67.2100029
6501600-016,泰山區福興里,901,511,222,131,49,76,138,2028,34,2062,3046,67.67499924
6501600-002,泰山區黎明里,955,471,174,96,34,55,141,1926,46,1972,2917,67.55999756
6502900-005,烏來區孝義里,72,29,15,4,4,5,22,151,2,153,229,66.80999756
6502900-002,烏來區忠治里,283,292,82,30,18,33,170,908,15,923,1431,64.5
6502900-004,烏來區信賢里,116,81,27,11,6,3,54,298,7,305,487,62.63000107
6502900-001,烏來區烏來里,460,408,131,56,26,41,238,1360,30,1390,2170,64.01000214
6502900-003,烏來區福山里,64,110,38,2,2,7,75,298,11,309,545,56.70000076
6502600-007,貢寮區仁里里,539,242,57,40,16,20,98,1012,33,1045,1676,62.33500099
6502600-002,貢寮區吉林里,142,68,25,10,6,3,25,279,15,294,469,62.68999863
6502600-011,貢寮區和美里,353,120,28,15,10,8,43,577,14,591,1007,58.69499969
6502600-010,貢寮區美豐里,238,79,23,19,2,8,59,428,26,454,741,61.21999931
6502600-008,貢寮區真理里,794,142,43,53,21,26,87,1166,33,1199,2061,58.17000008
6502600-001,貢寮區貢寮里,249,139,35,23,10,24,50,530,16,546,869,62.83000183
6502600-009,貢寮區福連里,285,136,24,31,10,2,45,533,14,547,913,59.88999939
6502600-006,貢寮區福隆里,461,293,54,41,16,20,108,993,26,1019,1651,61.62000084
6502600-005,貢寮區龍門里,268,84,15,10,1,9,25,412,12,424,679,62.43999863
6502600-004,貢寮區龍崗里,132,70,7,7,7,3,23,249,10,259,413,62.70999908
6502600-003,貢寮區雙玉里,252,103,15,10,2,7,36,425,10,435,730,60.15000153
6501000-020,淡水區八勢里,1089,730,181,196,89,232,309,2826,36,2862,4546,62.90000025
6501000-042,淡水區大庄里,1161,905,235,204,88,278,385,3256,35,3291,5208,64.25333405
6501000-001,淡水區中和里,159,66,10,12,2,7,137,393,10,403,531,75.88999939
6501000-023,淡水區中興里,959,657,117,137,47,92,369,2378,44,2422,3596,67.63666534
6501000-002,淡水區屯山里,326,126,18,25,25,11,140,671,22,693,1002,69.16000366
6501000-031,淡水區文化里,377,301,65,59,49,58,152,1061,18,1079,1588,67.94999695
6501000-013,淡水區水源里,651,258,71,62,27,35,225,1329,23,1352,2001,67.88000107
6501000-011,淡水區水碓里,1364,809,195,192,94,99,414,3167,57,3224,4893,65.92333221
6501000-012,淡水區北投里,1765,1415,331,364,159,284,529,4847,65,4912,7499,65.50400085
6501000-038,淡水區北新里,554,393,107,93,49,74,189,1459,22,1481,2312,64.08499908
6501000-037,淡水區正德里,832,678,160,144,69,135,285,2303,22,2325,3668,63.36999893
6501000-019,淡水區民生里,1508,976,224,237,112,233,567,3857,56,3913,6108,64.49500084
6501000-029,淡水區民安里,229,92,22,24,25,15,59,466,14,480,667,71.95999908
6501000-039,淡水區民權里,949,658,133,181,80,167,315,2483,41,2524,3708,68.06999969
6501000-028,淡水區永吉里,205,155,41,35,22,30,74,562,20,582,843,69.04000092
6501000-018,淡水區竹圍里,1404,981,239,184,100,204,460,3572,36,3608,5345,67.56499863
6501000-033,淡水區沙崙里,854,545,116,121,44,106,232,2018,42,2060,3336,61.85499954
6501000-027,淡水區協元里,378,238,42,50,23,22,134,887,23,910,1347,67.55999756
6501000-016,淡水區坪頂里,387,180,46,38,20,34,105,810,16,826,1294,63.83000183
6501000-040,淡水區幸福里,979,606,145,170,93,91,284,2368,49,2417,3609,66.90333557
6501000-007,淡水區忠山里,239,118,19,23,10,9,102,520,16,536,784,68.37000275
6501000-014,淡水區忠寮里,365,126,27,37,1,16,148,720,22,742,1060,70
6501000-032,淡水區油車里,1152,893,191,186,82,191,393,3088,59,3147,4778,65.82666524
6501000-024,淡水區長庚里,404,254,49,35,23,18,142,925,23,948,1351,70.16999817
6501000-021,淡水區竿蓁里,1899,1496,317,352,193,525,554,5336,97,5433,8735,62.44400024
6501000-008,淡水區崁頂里,1528,1295,282,315,116,369,514,4419,58,4477,7705,59.4299984
6501000-026,淡水區草東里,237,123,39,34,20,11,74,538,6,544,748,72.73000336
6501000-009,淡水區埤島里,362,217,37,66,23,26,148,879,31,910,1317,69.09999847
6501000-025,淡水區清文里,299,139,43,48,12,21,120,682,21,703,1075,65.40000153
6501000-036,淡水區新民里,986,720,189,145,101,137,354,2632,41,2673,3991,66.93999736
6501000-030,淡水區新生里,121,62,13,19,15,14,45,289,6,295,424,69.58000183
6501000-035,淡水區新春里,1443,1011,272,264,113,249,409,3761,58,3819,6046,63.27000046
6501000-034,淡水區新義里,1027,613,115,152,44,66,315,2332,41,2373,3548,66.86666616
6501000-010,淡水區新興里,1310,1074,269,225,117,198,409,3602,52,3654,5782,63.16499996
6501000-006,淡水區義山里,618,427,76,74,26,28,266,1515,46,1561,2476,63.22000122
6501000-017,淡水區福德里,1329,1140,268,237,120,319,420,3833,47,3880,5781,66.97499847
6501000-003,淡水區賢孝里,352,234,40,24,16,21,216,903,25,928,1411,65.76999664
6501000-022,淡水區鄧公里,1213,998,213,271,124,196,347,3362,41,3403,5098,66.90333303
6501000-041,淡水區學府里,871,669,143,161,54,100,307,2305,34,2339,3871,60.43000031
6501000-015,淡水區樹興里,357,150,36,35,15,58,122,773,14,787,1201,65.52999878
6501000-004,淡水區興仁里,410,218,66,49,20,41,171,975,26,1001,1506,66.47000122
6501000-005,淡水區蕃薯里,198,130,41,12,12,38,141,572,14,586,935,62.66999817
6501800-003,深坑區土庫里,694,499,115,89,41,75,136,1649,51,1700,2612,65.10499954
6501800-004,深坑區昇高里,543,392,86,47,39,90,123,1320,19,1339,1901,70.95000076
6501800-005,深坑區阿柔里,203,92,19,15,6,9,29,373,4,377,529,71.26999664
6501800-006,深坑區埔新里,1335,1017,231,240,94,183,291,3391,58,3449,5150,66.96999868
6501800-001,深坑區深坑里,798,524,116,105,40,80,161,1824,29,1853,2847,65.03000069
6501800-002,深坑區萬順里,627,426,96,75,40,55,115,1434,32,1466,2177,67.33499908
6501800-007,深坑區萬福里,674,389,95,68,54,69,139,1488,27,1515,2355,64.63999748
6501800-008,深坑區賴仲里,461,377,96,68,38,87,93,1220,19,1239,1912,64.74500084
6500600-013,新店區下城里,771,503,98,83,38,139,147,1779,23,1802,2781,64.72499847
6500600-004,新店區大同里,815,847,173,138,85,216,217,2491,36,2527,3561,70.98500061
6500600-003,新店區大豐里,707,745,161,105,100,202,169,2189,32,2221,3271,67.90999985
6500600-010,新店區大鵬里,184,838,93,62,54,302,146,1679,12,1691,2357,71.73999786
6500600-059,新店區小城里,544,776,190,107,86,305,267,2275,26,2301,3238,71.13000107
6500600-052,新店區中山里,642,1010,195,123,107,415,297,2789,21,2810,3988,70.10333506
6500600-054,新店區中央里,905,1147,187,198,143,571,293,3444,34,3478,4925,70.67000071
6500600-044,新店區中正里,1104,1342,238,163,122,470,325,3764,63,3827,5608,68.28249836
6500600-045,新店區中華里,616,901,178,148,84,308,223,2458,34,2492,3745,66.60000102
6500600-037,新店區中興里,957,1142,215,195,125,405,311,3350,35,3385,6740,57.25749874
6500600-041,新店區五峯里,1289,1435,238,178,186,515,362,4203,66,4269,6263,68.14999962
6500600-046,新店區仁愛里,373,445,85,59,46,166,98,1272,26,1298,1846,70.30999756
6500600-016,新店區公崙里,2019,2073,459,338,182,474,527,6072,84,6156,9294,66.23999914
6500600-011,新店區太平里,558,569,148,94,55,169,176,1769,34,1803,2672,67.18500137
6500600-034,新店區文中里,287,382,88,49,30,100,76,1012,10,1022,1531,66.75
6500600-036,新店區文明里,598,457,89,74,50,97,117,1482,32,1514,2105,71.95000076
6500600-019,新店區日興里,1294,941,251,170,53,183,294,3186,76,3262,5118,63.65000025
6500600-067,新店區永平里,1071,1023,222,166,100,250,287,3119,60,3179,4731,67.19333394
6500600-015,新店區永安里,1118,861,219,147,69,187,241,2842,66,2908,4461,65.05666606
6500600-057,新店區吉祥里,682,1026,224,117,82,365,227,2723,28,2751,4191,65.76333364
6500600-056,新店區安和里,1513,1210,283,211,101,286,352,3956,78,4034,6017,66.83250046
6500600-064,新店區安昌里,945,1001,218,160,82,283,243,2932,48,2980,4384,68.00999959
6500600-005,新店區江陵里,942,1147,208,214,142,419,290,3362,34,3396,4820,70.46000163
6500600-047,新店區百忍里,685,869,144,117,92,266,210,2383,43,2426,3483,69.57000224
6500600-048,新店區百和里,646,649,140,99,75,208,183,2000,30,2030,2928,69.30500031
6500600-050,新店區百福里,568,661,122,111,88,245,226,2021,24,2045,3022,67.74000168
6500600-053,新店區和平里,153,190,42,17,9,32,43,486,17,503,777,64.73999786
6500600-026,新店區屈尺里,709,365,96,72,35,75,134,1486,52,1538,2266,67.86000061
6500600-009,新店區忠孝里,438,594,106,70,41,177,128,1554,23,1577,2485,63.48500061
6500600-043,新店區忠誠里,452,546,112,58,58,167,137,1530,22,1552,2168,71.58499908
6500600-055,新店區明城里,505,714,154,99,73,304,163,2012,21,2033,3022,67.41500092
6500600-002,新店區明德里,711,818,171,129,88,240,227,2384,27,2411,3556,67.90666707
6500600-020,新店區玫瑰里,1007,1158,246,178,85,316,354,3344,65,3409,5172,65.94666799
6500600-029,新店區直潭里,417,149,47,33,21,22,54,743,16,759,1112,67.51999855
6500600-065,新店區長春里,367,445,85,89,88,243,166,1483,22,1505,2221,67.75500107
6500600-030,新店區青潭里,1140,865,237,162,97,298,278,3077,60,3137,4663,67.12333171
6500600-008,新店區信義里,1325,1230,235,198,146,335,317,3786,50,3836,5654,67.93250084
6500600-061,新店區建國里,483,660,135,91,79,235,186,1869,40,1909,2796,68.27000046
6500600-063,新店區美城里,495,512,136,79,46,146,178,1592,25,1617,2398,67.44999695
6500600-022,新店區美潭里,1016,985,224,150,79,318,273,3045,55,3100,4564,68.20666504
6500600-060,新店區香坡里,1439,1932,455,280,156,649,472,5383,69,5452,8671,63.51833344
6500600-023,新店區員潭里,979,892,195,118,63,164,254,2665,45,2710,4103,66.07000351
6500600-014,新店區柴埕里,1745,1524,352,248,173,380,411,4833,82,4915,7386,66.53999901
6500600-033,新店區國校里,521,407,98,73,60,122,131,1412,33,1445,2222,64.96500015
6500600-001,新店區國豐里,534,677,153,106,87,307,172,2036,35,2071,3033,68.22500229
6500600-040,新店區張北里,1329,1675,284,254,157,462,388,4549,71,4620,6968,66.22799911
6500600-032,新店區張南里,407,366,79,63,35,139,115,1204,12,1216,1825,66.62999725
6500600-025,新店區粗坑里,676,389,115,110,151,161,208,1810,31,1841,2742,68.93000031
6500600-012,新店區頂城里,343,274,89,40,10,52,85,893,14,907,1484,61.11999893
6500600-062,新店區復興里,657,608,105,88,55,120,175,1808,30,1838,2904,63.36499786
6500600-069,新店區華城里,425,413,86,98,54,184,139,1399,13,1412,2182,64.50499916
6500600-021,新店區塗潭里,391,98,28,21,7,9,60,614,16,630,891,70.70999908
6500600-038,新店區新生里,1084,1259,215,186,132,409,312,3597,60,3657,5234,69.89666748
6500600-042,新店區新安里,679,869,177,110,88,300,226,2449,44,2493,3676,67.80000051
6500600-066,新店區新和里,685,782,163,140,66,226,227,2289,32,2321,3573,64.96500015
6500600-031,新店區新店里,471,266,64,74,37,59,103,1074,22,1096,1550,70.70999908
6500600-039,新店區新德里,584,492,91,78,46,140,135,1566,26,1592,2407,66.11000061
6500600-068,新店區達觀里,467,740,160,112,74,269,209,2031,19,2050,3238,63.35000038
6500600-051,新店區福民里,507,866,162,120,81,369,267,2372,27,2399,3586,67.0150013
6500600-049,新店區福德里,758,835,178,136,79,242,215,2443,24,2467,3563,69.25
6500600-035,新店區廣明里,273,117,24,30,14,33,30,521,11,532,771,69
6500600-028,新店區廣興里,463,146,42,25,17,21,60,774,23,797,1246,63.95999908
6500600-017,新店區德安里,1407,1108,245,183,93,220,276,3532,65,3597,5422,66.33666738
6500600-027,新店區龜山里,462,260,54,56,11,34,88,965,28,993,1579,62.88999939
6500600-024,新店區雙坑里,274,104,19,16,8,12,40,473,13,486,749,64.88999939
6500600-018,新店區雙城里,1306,942,220,161,71,188,297,3185,55,3240,4953,65.10999966
6500600-007,新店區寶安里,909,1271,208,182,123,389,272,3354,56,3410,4989,68.44999949
6500600-058,新店區寶福里,1203,1434,312,223,141,415,396,4124,53,4177,6122,68.05750084
6500600-006,新店區寶興里,979,1073,167,178,130,340,285,3152,56,3208,4612,69.67333221
6500500-012,新莊區八德里,873,401,141,105,31,35,116,1702,27,1729,2691,64.33499908
6500500-075,新莊區中平里,1967,1089,383,354,108,231,318,4450,43,4493,6640,67.59599915
6500500-058,新莊區中全里,1153,388,166,143,51,28,158,2087,35,2122,3136,67.66500092
6500500-057,新莊區中宏里,1020,478,156,163,57,42,176,2092,39,2131,3163,67.38000107
6500500-014,新莊區中和里,1379,617,174,203,73,103,185,2734,43,2777,4022,69.0600001
6500500-054,新莊區中信里,2304,1036,374,397,116,138,349,4714,56,4770,6985,68.28999939
6500500-011,新莊區中美里,1704,773,235,247,80,105,251,3395,43,3438,4965,69.24333191
6500500-053,新莊區中原里,2558,1136,432,362,136,197,397,5218,64,5282,7910,66.83666611
6500500-017,新莊區中泰里,1377,524,200,193,49,67,186,2596,41,2637,3835,68.75666555
6500500-023,新莊區中港里,1712,874,262,238,131,141,246,3604,50,3654,5291,69.10250092
6500500-051,新莊區中華里,720,355,151,128,33,55,117,1559,15,1574,2311,68.22999954
6500500-052,新莊區中隆里,1167,579,184,195,57,60,161,2403,31,2434,3645,65.89333344
6500500-020,新莊區中誠里,664,251,107,78,25,25,90,1240,13,1253,1887,66.3900032
6500500-043,新莊區丹鳳里,2001,1049,395,241,80,124,324,4214,67,4281,6578,64.52599945
6500500-028,新莊區仁愛里,811,353,98,81,32,41,131,1547,20,1567,2380,65.72999954
6500500-061,新莊區仁義里,1171,425,155,121,35,47,168,2122,35,2157,3263,66.10499954
6500500-036,新莊區化成里,1010,428,133,149,30,39,148,1937,26,1963,2957,66.375
6500500-022,新莊區文明里,552,242,91,73,30,29,78,1095,9,1104,1558,70.86000061
6500500-065,新莊區文聖里,882,623,143,134,76,114,187,2159,20,2179,3051,71.41500092
6500500-019,新莊區文德里,474,257,90,64,38,43,82,1048,18,1066,1524,69.94999695
6500500-010,新莊區文衡里,608,313,87,101,45,52,92,1298,21,1319,1814,72.70999908
6500500-055,新莊區四維里,1306,522,198,166,47,61,178,2478,36,2514,3982,63.1200002
6500500-035,新莊區民本里,1003,344,118,86,48,26,111,1736,33,1769,2696,65.56499863
6500500-081,新莊區民全里,1043,543,119,150,47,66,143,2111,35,2146,3134,68.46500015
6500500-032,新莊區民安里,1571,889,267,225,59,88,220,3319,64,3383,4900,69.09000015
6500500-082,新莊區民有里,1067,517,193,133,56,62,172,2200,37,2237,3337,67.03499985
6500500-026,新莊區立人里,443,455,80,67,31,113,99,1288,17,1305,1948,66.95999908
6500500-034,新莊區立功里,1064,491,142,147,42,62,153,2101,30,2131,3167,67.27000046
6500500-076,新莊區立廷里,2560,1461,457,476,158,244,437,5793,67,5860,8691,67.4950002
6500500-037,新莊區立志里,1190,526,152,147,51,70,185,2321,32,2353,3376,69.66666667
6500500-031,新莊區立言里,1338,690,218,223,98,118,283,2968,26,2994,4361,68.66333516
6500500-059,新莊區立泰里,1310,680,184,177,76,82,190,2699,54,2753,4125,66.73666636
6500500-062,新莊區立基里,1601,885,278,271,125,106,290,3556,49,3605,5252,68.41250038
6500500-029,新莊區立德里,657,384,125,117,48,61,133,1525,17,1542,2209,69.83000183
6500500-083,新莊區光正里,1173,635,184,161,52,58,172,2435,37,2472,3564,69.3799998
6500500-084,新莊區光和里,866,359,107,103,33,32,112,1612,30,1642,2350,69.81999969
6500500-044,新莊區光明里,1185,608,181,139,49,48,198,2408,56,2464,3703,66.57666779
6500500-038,新莊區光華里,1908,937,269,271,71,107,263,3826,65,3891,5838,66.62749958
6500500-041,新莊區光榮里,1111,644,168,168,48,77,170,2386,48,2434,3634,66.99666595
6500500-004,新莊區全安里,1263,617,193,180,75,98,193,2619,29,2648,3767,70.44999949
6500500-060,新莊區全泰里,1316,846,212,177,88,140,256,3035,34,3069,4313,71.19333394
6500500-046,新莊區合鳳里,1240,581,197,178,60,55,188,2499,40,2539,3903,65.05333455
6500500-071,新莊區成德里,1345,655,215,156,61,58,209,2699,53,2752,4177,65.8799998
6500500-045,新莊區自立里,1600,713,223,193,69,89,240,3127,46,3173,4619,68.57000224
6500500-049,新莊區自信里,770,317,84,81,28,45,90,1415,25,1440,2159,66.6649971
6500500-042,新莊區自強里,822,310,117,94,24,40,132,1539,19,1558,2368,65.78499985
6500500-015,新莊區西盛里,2915,1409,436,389,131,151,406,5837,98,5935,8544,69.48166656
6500500-033,新莊區和平里,1449,556,185,228,68,81,213,2780,32,2812,4170,67.41666667
6500500-047,新莊區幸福里,1339,508,172,166,46,52,172,2455,46,2501,3809,65.64333089
6500500-007,新莊區忠孝里,1342,706,198,207,73,85,205,2816,41,2857,4187,68.1766688
6500500-064,新莊區昌平里,1244,775,236,233,76,112,227,2903,31,2934,4498,65.21666718
6500500-063,新莊區昌明里,1050,445,158,147,60,61,187,2108,28,2136,3118,68.50499725
6500500-073,新莊區昌信里,928,446,172,140,63,73,150,1972,19,1991,2923,68.12000275
6500500-074,新莊區昌隆里,1089,578,180,187,57,98,192,2381,35,2416,3571,67.57333374
6500500-030,新莊區信義里,1480,713,218,204,67,84,236,3002,49,3051,4607,66.23000081
6500500-027,新莊區南港里,1401,755,243,197,74,63,225,2958,41,2999,4520,66.33499908
6500500-070,新莊區建安里,1773,809,257,252,107,107,241,3546,56,3602,5470,65.84000015
6500500-056,新莊區建福里,711,380,130,132,43,51,100,1547,27,1574,2278,69.13499832
6500500-009,新莊區後港里,2004,959,349,306,128,108,311,4165,60,4225,6049,69.84749985
6500500-069,新莊區後德里,868,473,118,144,68,78,124,1873,29,1902,2670,71.18500137
6500500-025,新莊區思源里,1639,666,218,215,69,89,230,3126,35,3161,4618,68.45666504
6500500-039,新莊區思賢里,1195,606,189,184,53,76,208,2511,39,2550,3582,71.17666626
6500500-008,新莊區恆安里,1187,645,218,176,82,104,174,2586,35,2621,3834,68.38000234
6500500-077,新莊區泰豐里,646,320,130,87,33,36,102,1354,17,1371,2067,66.35499954
6500500-001,新莊區海山里,1506,755,234,221,71,99,257,3143,37,3180,4630,68.70499992
6500500-003,新莊區國泰里,424,228,76,68,23,21,67,907,13,920,1323,69.54000092
6500500-080,新莊區祥鳳里,642,322,103,88,31,41,111,1338,16,1354,2013,67.29000092
6500500-078,新莊區富民里,1013,502,176,136,51,56,156,2090,30,2120,3200,66.23500061
6500500-024,新莊區富國里,742,316,119,82,33,23,109,1424,34,1458,2152,67.77000046
6500500-066,新莊區萬安里,1030,480,157,135,48,57,170,2077,37,2114,3300,64.06499863
6500500-021,新莊區裕民里,1974,873,286,246,88,101,290,3858,63,3921,5849,67.06499863
6500500-016,新莊區榮和里,727,445,120,118,48,88,112,1658,28,1686,4282,48.63000011
6500500-005,新莊區福基里,1008,531,163,150,71,93,170,2186,25,2211,3377,65.71333313
6500500-072,新莊區福興里,1597,735,239,221,74,77,274,3217,42,3259,4709,69.21000099
6500500-068,新莊區福營里,774,331,109,115,29,42,99,1499,28,1527,2264,67.82500076
6500500-013,新莊區興漢里,848,608,150,137,68,85,147,2043,27,2070,3044,68.11333211
6500500-002,新莊區頭前里,1947,840,239,280,103,152,252,3813,39,3852,5708,67.47500038
6500500-067,新莊區龍安里,629,314,73,85,32,32,91,1256,27,1283,2003,64.08499908
6500500-079,新莊區龍福里,500,346,100,73,27,55,81,1182,18,1200,1880,63.8599987
6500500-050,新莊區龍鳳里,2227,1147,320,330,132,147,339,4642,49,4691,6994,67.04999847
6500500-040,新莊區營盤里,752,348,90,95,33,28,91,1437,24,1461,2053,70.875
6500500-006,新莊區豐年里,1057,510,148,185,63,53,147,2163,39,2202,3252,67.73666636
6500500-048,新莊區雙鳳里,2421,1364,448,364,128,180,462,5367,66,5433,8514,63.74333382
6500500-018,新莊區瓊林里,1859,729,214,204,85,73,224,3388,37,3425,5048,67.87999916
6501200-010,瑞芳區上天里,332,244,68,26,12,16,68,766,33,799,1296,61.58000183
6501200-016,瑞芳區弓橋里,100,30,9,8,5,8,15,175,0,175,311,56.27000046
6501200-007,瑞芳區爪峯里,926,642,168,135,38,70,214,2193,73,2266,3534,63.79000092
6501200-019,瑞芳區永慶里,107,66,14,11,1,4,32,235,3,238,449,53.00999832
6501200-024,瑞芳區瓜山里,44,50,4,5,7,3,12,125,3,128,194,65.98000336
6501200-026,瑞芳區石山里,47,73,14,8,2,11,37,192,4,196,344,56.97999954
6501200-015,瑞芳區光復里,95,47,4,4,0,8,21,179,6,185,298,62.08000183
6501200-012,瑞芳區吉安里,698,546,128,98,37,55,162,1724,52,1776,2912,60.75
6501200-011,瑞芳區吉慶里,371,340,70,47,27,26,76,957,30,987,1641,60.15999985
6501200-009,瑞芳區東和里,427,298,77,53,17,32,120,1024,20,1044,1664,62.61499977
6501200-032,瑞芳區南雅里,67,35,4,7,0,3,55,171,1,172,255,67.44999695
6501200-008,瑞芳區柑坪里,323,193,48,27,14,16,74,695,18,713,1068,66.76000214
6501200-029,瑞芳區海濱里,211,229,71,24,9,20,113,677,29,706,1190,59.33000183
6501200-018,瑞芳區基山里,127,67,19,13,5,16,35,282,5,287,472,60.81000137
6501200-020,瑞芳區崇文里,81,55,8,9,2,4,14,173,6,179,335,53.43000031
6501200-031,瑞芳區深澳里,224,226,67,25,7,23,100,672,23,695,1212,57.34000015
6501200-013,瑞芳區傑魚里,497,298,80,72,20,28,111,1106,27,1133,1873,60.42500114
6501200-014,瑞芳區猴硐里,130,56,39,9,5,5,27,271,7,278,475,58.52999878
6501200-023,瑞芳區新山里,80,49,15,12,3,4,73,236,6,242,374,64.70999908
6501200-034,瑞芳區新峰里,638,543,114,96,30,51,163,1635,52,1687,2831,59.77000046
6501200-030,瑞芳區瑞濱里,413,323,109,49,11,25,104,1034,45,1079,1951,55.26999855
6501200-022,瑞芳區頌德里,80,69,10,14,1,8,20,202,8,210,358,58.65999985
6501200-017,瑞芳區碩仁里,45,21,6,4,2,8,23,109,3,112,180,62.22000122
6501200-021,瑞芳區福住里,35,38,2,6,1,0,18,100,4,104,178,58.43000031
6501200-025,瑞芳區銅山里,52,37,10,6,3,2,26,136,2,138,196,70.41000366
6501200-033,瑞芳區鼻頭里,204,133,32,17,4,12,31,433,8,441,860,51.27999878
6501200-028,瑞芳區濂洞里,85,81,16,11,2,11,83,289,8,297,493,60.24000168
6501200-027,瑞芳區濂新里,68,47,17,2,1,2,11,148,8,156,293,53.24000168
6501200-005,瑞芳區龍山里,289,256,63,51,12,44,96,811,27,838,1299,64.51000214
6501200-004,瑞芳區龍川里,413,299,91,54,14,40,99,1010,25,1035,1546,66.61000061
6501200-006,瑞芳區龍安里,123,125,38,17,2,16,41,362,13,375,595,63.02999878
6501200-001,瑞芳區龍潭里,172,143,34,21,10,10,55,445,11,456,698,65.33000183
6501200-002,瑞芳區龍興里,470,441,85,64,30,35,100,1225,29,1254,1845,67.625
6501200-003,瑞芳區龍鎮里,299,267,68,41,13,28,78,794,20,814,1213,67.11000061
6502800-004,萬里區大鵬里,723,531,109,79,23,44,154,1663,38,1701,2630,64.39500237
6502800-009,萬里區中幅里,272,187,53,23,8,14,60,617,21,638,1046,60.99000168
6502800-010,萬里區北基里,581,470,145,73,23,77,156,1525,28,1553,2851,54.51000023
6502800-008,萬里區崁脚里,123,62,21,11,4,5,21,247,6,253,411,61.56000137
6502800-003,萬里區野柳里,791,558,121,69,23,34,187,1783,52,1835,3114,58.95000076
6502800-007,萬里區溪底里,214,73,22,10,1,11,40,371,11,382,678,56.34000015
6502800-001,萬里區萬里里,1006,795,168,121,42,44,248,2424,55,2479,4119,60.07666651
6502800-002,萬里區龜吼里,581,341,95,48,14,45,189,1313,37,1350,2397,56.22500038
6502800-005,萬里區磺潭里,148,138,24,8,2,11,35,366,11,377,555,67.93000031
6502800-006,萬里區雙興里,310,142,33,22,8,9,65,589,15,604,956,63.18000031
6500700-001,樹林區三多里,1178,543,137,126,39,56,156,2235,50,2285,3452,66.44000244
6500700-002,樹林區三福里,1014,700,169,130,48,80,166,2307,41,2348,3425,68.55000051
6500700-003,樹林區三興里,1301,627,211,161,59,51,231,2641,48,2689,4111,65.60666911
6500700-042,樹林區三龍里,629,357,65,82,23,38,74,1268,23,1291,1794,71.64500046
6500700-014,樹林區大同里,839,573,152,140,42,77,171,1994,26,2020,2889,69.92000198
6500700-035,樹林區山佳里,1508,806,251,177,56,91,246,3135,59,3194,4795,66.94499969
6500700-036,樹林區中山里,1416,735,200,171,50,76,221,2869,68,2937,4388,66.9399999
6500700-038,樹林區中華里,803,477,157,133,48,39,126,1783,33,1816,2763,65.72500229
6500700-039,樹林區太順里,710,381,105,113,35,28,112,1484,27,1511,2370,63.78499794
6500700-034,樹林區文林里,1390,732,207,195,49,80,228,2881,35,2916,4248,68.65333303
6500700-025,樹林區北園里,713,261,98,83,20,14,89,1278,21,1299,1891,68.45999908
6500700-031,樹林區光興里,1101,467,163,137,44,80,155,2147,46,2193,3322,66.05333201
6500700-040,樹林區圳民里,751,439,129,108,31,49,121,1628,26,1654,2396,69.04999924
6500700-041,樹林區圳生里,620,185,62,73,16,24,86,1066,18,1084,1532,70.76000214
6500700-004,樹林區圳安里,1054,437,121,137,39,48,155,1991,25,2016,2984,67.59333038
6500700-028,樹林區圳福里,1155,638,196,163,43,58,201,2454,39,2493,3719,67.12333425
6500700-023,樹林區西園里,614,211,60,54,24,15,94,1072,6,1078,1570,68.66000366
6500700-037,樹林區育英里,839,480,126,129,58,52,162,1846,25,1871,2601,71.90999985
6500700-015,樹林區和平里,1103,543,135,153,57,41,189,2221,41,2262,3378,66.89333598
6500700-012,樹林區坡內里,509,260,74,49,8,13,73,986,17,1003,1461,68.65000153
6500700-018,樹林區東山里,949,444,154,129,27,48,164,1915,40,1955,2765,70.54999924
6500700-020,樹林區東昇里,1359,771,205,194,51,75,217,2872,61,2933,4043,72.80000051
6500700-019,樹林區東陽里,1525,908,205,203,68,55,279,3243,68,3311,4943,66.96250153
6500700-022,樹林區東園里,612,212,53,55,19,13,86,1050,26,1076,1525,70.55999756
6500700-032,樹林區金寮里,1190,650,150,137,32,45,181,2385,43,2428,3556,68.25999959
6500700-005,樹林區保安里,1791,956,258,252,91,104,278,3730,63,3793,5439,69.82999992
6500700-024,樹林區南園里,2563,1932,520,472,209,570,638,6904,81,6985,10650,65.65571322
6500700-026,樹林區柑園里,1740,1300,325,297,156,325,453,4596,62,4658,6882,67.6519989
6500700-016,樹林區彭厝里,1422,639,212,203,53,74,219,2822,60,2882,4255,67.71666718
6500700-017,樹林區彭福里,1325,727,195,210,55,76,200,2788,37,2825,4263,66.30666606
6500700-033,樹林區彭興里,1649,756,218,206,68,59,259,3215,42,3257,5001,64.97749901
6500700-007,樹林區獇寮里,1332,689,186,163,53,55,189,2667,61,2728,4164,65.52666855
6500700-021,樹林區樂山里,522,233,60,54,13,32,84,998,13,1011,1513,66.81999969
6500700-006,樹林區潭底里,1166,591,144,149,53,56,184,2343,45,2388,4170,60.12333298
6500700-011,樹林區樹人里,787,585,154,121,57,90,163,1957,39,1996,2828,70.36499786
6500700-027,樹林區樹北里,297,167,52,22,15,18,61,632,19,651,866,75.16999817
6500700-009,樹林區樹西里,1325,851,208,233,76,130,271,3094,38,3132,4461,70.25666809
6500700-013,樹林區樹東里,315,224,65,30,12,28,67,741,11,752,1093,68.80000305
6500700-010,樹林區樹南里,1151,641,191,188,65,90,195,2521,54,2575,3642,70.69666799
6500700-030,樹林區樹福里,995,572,119,169,72,87,170,2184,41,2225,3019,73.76999664
6500700-008,樹林區樹德里,1049,627,126,151,59,87,186,2285,41,2326,3209,72.09666697
6500700-029,樹林區樹興里,929,582,123,149,51,76,187,2097,44,2141,3172,67.17666626
6502500-005,雙溪區三港里,120,64,12,6,2,5,30,239,4,243,422,57.58000183
6502500-007,雙溪區三貂里,89,59,4,11,3,1,14,181,3,184,336,54.75999832
6502500-009,雙溪區上林里,186,88,22,18,5,6,65,390,9,399,644,61.95999908
6502500-010,雙溪區外柑里,130,94,8,3,2,2,19,258,11,269,441,61
6502500-008,雙溪區平林里,234,188,43,17,6,21,63,572,22,594,935,63.07500076
6502500-002,雙溪區共和里,92,79,23,10,3,6,25,238,6,244,404,60.95999908
6502500-006,雙溪區牡丹里,412,311,56,38,23,28,97,965,45,1010,1628,61.99500084
6502500-011,雙溪區長源里,128,36,10,7,0,3,31,215,10,225,373,60.31999969
6502500-012,雙溪區泰平里,212,139,43,17,15,15,62,503,14,517,915,58.29999924
6502500-004,雙溪區魚行里,183,124,31,18,7,15,48,426,10,436,706,61.75500107
6502500-003,雙溪區新基里,194,185,26,19,9,10,43,486,16,502,787,62.3900013
6502500-001,雙溪區雙溪里,97,116,19,11,7,9,23,282,4,286,454,63
6501400-024,蘆洲區九芎里,1505,626,199,182,68,73,190,2843,41,2884,4497,64.13666916
6501400-002,蘆洲區中原里,1507,616,194,190,64,86,227,2884,55,2939,4524,64.98666763
6501400-025,蘆洲區中華里,997,417,106,143,47,54,180,1944,32,1976,2828,69.875
6501400-003,蘆洲區中路里,1204,521,138,136,44,71,190,2304,34,2338,3366,69.38999939
6501400-013,蘆洲區仁復里,628,322,73,78,21,30,109,1261,23,1284,1863,68.91999817
6501400-022,蘆洲區仁愛里,1541,629,190,239,66,60,248,2973,46,3019,4459,67.68000031
6501400-028,蘆洲區仁義里,1191,470,154,172,68,77,177,2309,33,2342,4585,55.09499931
6501400-027,蘆洲區仁德里,1625,643,214,185,73,90,253,3083,40,3123,4730,66.02333323
6501400-021,蘆洲區水河里,2504,1062,348,336,85,124,394,4853,87,4940,7722,63.91199951
6501400-006,蘆洲區水湳里,2860,1193,363,382,119,144,434,5495,71,5566,8514,65.39600067
6501400-001,蘆洲區正義里,2883,1455,431,448,150,236,508,6111,63,6174,8978,68.70833333
6501400-032,蘆洲區民和里,809,378,133,95,22,36,171,1644,32,1676,2398,70.30999756
6501400-035,蘆洲區永安里,1522,628,191,168,53,62,220,2844,46,2890,4363,66.13666789
6501400-017,蘆洲區永康里,1921,751,242,266,67,80,274,3601,57,3658,5552,65.79500198
6501400-038,蘆洲區永德里,1179,484,179,182,49,54,189,2316,51,2367,3747,63.17499924
6501400-016,蘆洲區永樂里,1775,722,234,228,77,96,231,3363,42,3405,5133,66.36000061
6501400-019,蘆洲區玉清里,1518,692,233,198,70,119,247,3077,60,3137,4775,65.63000107
6501400-029,蘆洲區光明里,1361,541,168,179,50,62,230,2591,46,2637,4059,64.9866689
6501400-004,蘆洲區光華里,1406,701,185,185,74,84,233,2868,50,2918,4331,67.32333628
6501400-037,蘆洲區成功里,2110,873,276,271,68,103,296,3997,55,4052,6121,66.20249748
6501400-036,蘆洲區延平里,1265,451,154,134,43,60,155,2262,43,2305,3486,66.125
6501400-033,蘆洲區忠孝里,826,258,83,95,29,44,88,1423,23,1446,2138,67.54000092
6501400-023,蘆洲區忠義里,913,395,123,100,40,52,140,1763,31,1794,2706,66.27999878
6501400-031,蘆洲區長安里,1507,526,163,161,64,51,196,2668,37,2705,4311,62.76999919
6501400-005,蘆洲區保佑里,1028,490,163,149,37,49,201,2117,30,2147,3213,66.85499954
6501400-012,蘆洲區保和里,772,325,76,82,36,33,137,1461,36,1497,2263,66.09000015
6501400-030,蘆洲區保新里,816,343,107,93,28,29,155,1571,30,1601,2345,68.30500031
6501400-018,蘆洲區信義里,1229,496,130,166,46,34,212,2313,27,2340,3503,66.84499741
6501400-015,蘆洲區南港里,1612,645,227,198,51,82,243,3058,44,3102,4772,65.00999705
6501400-009,蘆洲區恆德里,1629,827,210,225,71,138,311,3411,58,3469,5256,66.00333405
6501400-026,蘆洲區得仁里,971,394,100,126,41,36,121,1789,26,1815,2671,67.98500061
6501400-014,蘆洲區得勝里,973,438,118,108,48,46,170,1901,28,1929,2909,66.36500168
6501400-020,蘆洲區復興里,1147,342,111,118,38,34,161,1951,39,1990,2988,66.66500092
6501400-010,蘆洲區溪墘里,1043,379,111,129,34,45,176,1917,23,1940,2794,69.43999863
6501400-034,蘆洲區福安里,971,407,120,124,46,56,152,1876,29,1905,2746,69.43999863
6501400-007,蘆洲區樓厝里,1685,845,226,251,62,128,262,3459,55,3514,5308,66.31999969
6501400-011,蘆洲區樹德里,976,506,126,127,37,50,175,1997,27,2024,2924,69.11999893
6501400-008,蘆洲區鷺江里,1541,709,210,214,65,72,282,3093,51,3144,4610,68.20333354
6500800-012,鶯歌區二甲里,284,143,28,45,4,6,59,569,27,596,837,71.20999908
6500800-011,鶯歌區二橋里,2120,1009,291,239,77,79,365,4180,97,4277,6458,66.10000038
6500800-014,鶯歌區大湖里,1288,906,208,177,69,102,298,3048,49,3097,4622,67.03000132
6500800-018,鶯歌區中湖里,1446,936,242,178,65,54,264,3185,67,3252,5019,65.11000061
6500800-005,鶯歌區中鶯里,321,196,36,35,20,14,57,679,13,692,928,74.56999969
6500800-004,鶯歌區北鶯里,885,626,154,142,63,94,184,2148,32,2180,3537,61.54500008
6500800-017,鶯歌區永吉里,1329,787,207,136,49,47,238,2793,80,2873,4142,69.44999949
6500800-008,鶯歌區永昌里,2168,1250,378,262,111,97,390,4656,74,4730,7054,67.47200012
6500800-007,鶯歌區同慶里,554,229,70,57,26,21,92,1049,12,1061,1503,70.58999634
6500800-010,鶯歌區尖山里,1900,935,292,228,83,110,293,3841,81,3922,5942,66.0625
6500800-002,鶯歌區西鶯里,624,395,88,81,39,50,96,1373,22,1395,1964,70.94499969
6500800-013,鶯歌區東湖里,82,40,9,10,3,2,25,171,3,174,247,70.44999695
6500800-001,鶯歌區東鶯里,312,165,61,38,12,18,52,658,10,668,904,73.88999939
6500800-009,鶯歌區南靖里,1005,558,159,143,44,57,192,2158,42,2200,3180,68.76999664
6500800-003,鶯歌區南鶯里,1626,809,217,205,94,92,244,3287,71,3358,4866,68.96666718
6500800-020,鶯歌區建國里,1650,891,289,223,88,87,300,3528,57,3585,5549,64.64999898
6500800-006,鶯歌區建德里,163,103,35,12,3,2,30,348,6,354,480,73.75
6500800-019,鶯歌區鳳祥里,1265,671,169,130,60,58,199,2552,58,2610,3966,65.53666814
6500800-016,鶯歌區鳳福里,1168,622,146,114,55,71,204,2380,54,2434,3587,67.97999827
6500800-015,鶯歌區鳳鳴里,1241,696,184,151,45,35,259,2611,52,2663,3981,66.8700002
6800800-036,八德區大千里,451,481,106,90,39,59,103,1329,29,1358,2007,67.66000366
6800800-026,八德區大仁里,1290,664,209,152,47,59,251,2672,44,2716,3900,69.64500046
6800800-030,八德區大正里,934,815,162,149,64,94,201,2419,36,2455,3730,65.78499985
6800800-018,八德區大同里,472,261,47,48,19,41,69,957,14,971,1429,67.94999695
6800800-015,八德區大安里,934,520,172,119,57,39,152,1993,34,2027,2952,68.99000168
6800800-019,八德區大成里,956,694,130,100,58,83,157,2178,40,2218,3107,71.38999939
6800800-034,八德區大竹里,504,251,83,57,20,11,90,1016,13,1029,1435,71.70999908
6800800-042,八德區大宏里,758,690,156,124,57,100,164,2049,37,2086,2918,71.44499969
6800800-017,八德區大和里,1205,1338,311,199,98,215,380,3746,79,3825,5979,64.75999928
6800800-021,八德區大忠里,401,373,85,59,20,50,89,1077,23,1100,1635,67.27999878
6800800-029,八德區大昌里,745,661,127,85,44,63,116,1841,29,1870,2694,69.43000031
6800800-033,八德區大明里,1008,562,146,150,59,65,176,2166,26,2192,3277,66.9849968
6800800-024,八德區大信里,758,989,156,65,43,101,200,2312,81,2393,3647,66.52666728
6800800-023,八德區大勇里,1057,726,165,148,84,121,227,2528,33,2561,3632,70.56999969
6800800-031,八德區大強里,1003,552,149,104,40,50,166,2064,26,2090,2856,73.19499969
6800800-027,八德區大智里,657,837,174,147,65,161,210,2251,45,2296,3371,68.10500336
6800800-014,八德區大湳里,1073,582,157,114,64,79,223,2292,41,2333,3618,64.46999931
6800800-032,八德區大發里,615,300,100,58,20,21,110,1224,25,1249,1895,65.91000366
6800800-025,八德區大華里,568,551,132,97,42,52,128,1570,31,1601,2310,69.22000122
6800800-048,八德區大順里,681,481,144,82,44,55,114,1601,25,1626,2495,65.39999962
6800800-041,八德區大愛里,543,528,125,97,26,33,190,1542,21,1563,2310,67.66500092
6800800-020,八德區大義里,785,846,156,98,71,73,185,2214,50,2264,3470,65.25
6800800-037,八德區大榮里,489,365,100,66,34,55,80,1189,29,1218,1828,66.62999725
6800800-043,八德區大漢里,777,779,185,125,72,101,151,2190,38,2228,3440,64.77500153
6800800-022,八德區大福里,1386,972,237,184,107,120,257,3263,55,3318,4686,70.8066686
6800800-035,八德區大慶里,358,259,61,58,24,54,93,907,16,923,1372,67.26999664
6800800-016,八德區大興里,929,663,150,104,46,82,158,2132,34,2166,3170,68.31000137
6800800-047,八德區永豐里,799,481,138,87,39,45,166,1755,66,1821,2685,67.82999802
6800800-013,八德區白鷺里,901,524,155,104,60,49,142,1935,42,1977,2946,67.24499893
6800800-009,八德區竹園里,890,630,133,110,64,55,196,2078,48,2126,3193,66.58499908
6800800-038,八德區茄明里,1004,709,259,123,66,107,209,2477,58,2535,4051,62.63000107
6800800-011,八德區茄苳里,742,422,145,100,37,42,137,1625,27,1652,2378,69.41999817
6800800-012,八德區高明里,963,663,195,113,63,55,196,2248,39,2287,3545,64.50499916
6800800-039,八德區高城里,738,602,175,108,53,60,170,1906,43,1949,2911,67.10000229
6800800-046,八德區陸光里,371,1595,223,82,45,197,227,2740,50,2790,4113,67.82666651
6800800-028,八德區瑞泰里,1034,741,206,128,66,106,238,2519,47,2566,3920,65.37666575
6800800-006,八德區瑞祥里,573,936,160,66,43,95,196,2069,51,2120,3138,67.57500076
6800800-004,八德區瑞發里,733,785,160,91,53,85,165,2072,54,2126,3110,68.32999802
6800800-005,八德區瑞德里,669,976,160,78,40,80,160,2163,40,2203,3366,65.57500076
6800800-040,八德區瑞興里,823,460,116,89,39,56,140,1723,32,1755,2451,71.61500168
6800800-003,八德區瑞豐里,529,525,133,76,30,68,123,1484,47,1531,2423,63.18999863
6800800-002,八德區福興里,1418,1014,272,158,84,117,299,3362,66,3428,5408,63.58666738
6800800-008,八德區廣隆里,1058,933,207,168,77,101,212,2756,44,2800,3971,70.58999888
6800800-044,八德區廣德里,741,466,128,66,69,49,135,1654,29,1683,2515,66.84500122
6800800-007,八德區廣興里,844,609,147,102,50,55,168,1975,36,2011,3101,64.8200016
6800800-010,八德區霄裡里,540,345,105,57,26,30,129,1232,24,1256,1964,63.95000076
6800800-001,八德區興仁里,1080,891,195,178,79,102,277,2802,42,2844,5218,54.34333293
6800800-045,八德區龍友里,265,766,146,43,27,92,118,1457,44,1501,2105,71.50499725
6800600-010,大園區三石里,981,431,129,99,43,43,148,1874,52,1926,2728,70.60000229
6800600-008,大園區大海里,408,374,75,47,24,17,93,1038,21,1059,1524,69.48999786
6800600-001,大園區大園里,1792,1061,254,253,80,46,304,3790,89,3879,5753,67.59249973
6800600-006,大園區五權里,1719,668,154,168,85,40,224,3058,93,3151,4427,71.13333384
6800600-017,大園區內海里,713,341,103,77,26,22,102,1384,30,1414,2073,68.20999908
6800600-018,大園區北港里,817,370,110,87,31,19,138,1572,41,1613,2433,66.83499908
6800600-002,大園區田心里,1772,954,232,219,96,56,335,3664,95,3759,5637,66.89333089
6800600-016,大園區圳頭里,808,415,79,70,29,31,145,1577,48,1625,2374,68.43999863
6800600-012,大園區竹圍里,860,564,141,113,56,59,188,1981,48,2029,2959,68.58000183
6800600-014,大園區沙崙里,732,458,128,81,34,26,142,1601,58,1659,2584,64.13500023
6800600-004,大園區和平里,619,218,43,44,28,11,86,1049,29,1078,1543,69.86000061
6800600-019,大園區南港里,1172,677,278,157,57,61,257,2659,56,2715,4484,60.46666718
6800600-015,大園區後厝里,689,429,116,91,37,20,137,1519,50,1569,2299,68.22499847
6800600-007,大園區埔心里,1859,852,217,184,104,74,293,3583,68,3651,5605,65.0933342
6800600-013,大園區海口里,485,322,89,66,27,32,94,1115,41,1156,1683,68.69000244
6800600-011,大園區菓林里,1947,1000,279,232,95,104,363,4020,83,4103,6313,65.19000053
6800600-003,大園區溪海里,1335,670,185,118,44,39,226,2617,66,2683,4217,63.67666499
6800600-005,大園區橫峰里,2243,1360,348,321,135,155,465,5027,87,5114,7660,66.67000122
6800300-003,大溪區一心里,1421,680,156,194,79,74,265,2869,59,2928,4438,65.99666723
6800300-004,大溪區一德里,1744,741,232,155,55,94,297,3318,67,3385,5169,65.50500107
6800300-024,大溪區三元里,469,821,132,85,58,105,165,1835,25,1860,2724,68.29000092
6800300-014,大溪區中新里,644,215,53,45,12,23,71,1063,18,1081,1485,72.45000076
6800300-026,大溪區仁文里,889,699,173,120,44,68,258,2251,40,2291,3495,65.6533343
6800300-027,大溪區仁和里,1150,866,203,132,67,101,272,2791,39,2830,4155,68.12333171
6800300-019,大溪區仁武里,737,579,145,85,63,83,155,1847,26,1873,2815,66.54499817
6800300-017,大溪區仁善里,1690,1272,285,191,92,162,294,3986,65,4051,6198,65.33500004
6800300-018,大溪區仁愛里,1232,874,254,148,57,61,285,2911,72,2983,4443,67.00999959
6800300-015,大溪區仁義里,350,958,118,53,35,84,138,1736,58,1794,2731,65.67500305
6800300-005,大溪區月眉里,484,142,41,45,16,12,67,807,14,821,1172,70.05000305
6800300-006,大溪區永福里,396,102,27,21,11,14,56,627,10,637,949,67.12000275
6800300-025,大溪區田心里,1504,633,183,162,104,79,238,2903,46,2949,4326,68.15333557
6800300-023,大溪區光明里,405,621,105,59,37,72,140,1439,36,1475,2302,64.08000183
6800300-021,大溪區南興里,1499,738,194,129,65,69,252,2946,67,3013,4648,64.87000148
6800300-007,大溪區美華里,1188,355,98,88,39,52,155,1975,48,2023,2889,69.92000071
6800300-020,大溪區員林里,355,316,55,48,23,28,73,898,22,920,1426,64.51999664
6800300-011,大溪區康安里,499,144,44,55,15,17,76,850,18,868,1219,71.20999908
6800300-009,大溪區復興里,331,102,35,28,11,9,64,580,12,592,899,65.84999847
6800300-010,大溪區新峰里,312,111,40,9,4,5,54,535,21,556,796,69.84999847
6800300-022,大溪區瑞源里,1063,634,163,100,39,96,228,2323,47,2370,3533,67.19999949
6800300-013,大溪區瑞興里,871,394,136,80,41,19,187,1728,41,1769,2557,68.9600029
6800300-012,大溪區義和里,711,196,59,44,30,26,97,1163,24,1187,1717,68.88999939
6800300-016,大溪區僑愛里,225,854,103,54,27,249,120,1632,23,1655,2424,68.40999985
6800300-002,大溪區福仁里,377,129,19,41,9,10,71,656,9,665,932,71.34999847
6800300-008,大溪區福安里,842,253,94,78,35,23,156,1481,27,1508,2187,69.15500259
6800300-001,大溪區興和里,558,249,49,57,44,16,100,1073,18,1091,1518,71.87000275
6800200-048,中壢區三民里,1065,482,136,85,87,35,167,2057,41,2098,2977,70.38999939
6800200-049,中壢區山東里,1415,455,150,97,76,38,176,2407,38,2445,3395,71.95999908
6800200-068,中壢區中山里,777,946,261,136,130,149,230,2629,35,2664,4206,63.34999975
6800200-015,中壢區中央里,867,719,144,130,120,120,234,2334,25,2359,3358,70.25666809
6800200-019,中壢區中正里,783,1100,255,120,122,136,225,2741,39,2780,4334,64.17333349
6800200-040,中壢區中建里,324,157,32,46,34,27,64,684,9,693,973,71.22000122
6800200-026,中壢區中原里,926,784,169,116,94,121,200,2410,41,2451,3570,68.70000076
6800200-010,中壢區中堅里,589,952,182,93,74,110,209,2209,35,2244,3437,65.86333466
6800200-050,中壢區中榮里,256,165,30,29,29,18,42,569,7,576,851,67.69000244
6800200-081,中壢區中興里,507,697,173,111,88,95,180,1851,20,1871,2884,64.92000008
6800200-028,中壢區中壢里,214,166,23,25,20,10,35,493,7,500,709,70.51999664
6800200-064,中壢區五福里,1072,612,117,127,126,67,210,2331,38,2369,3362,70.5
6800200-044,中壢區五權里,1682,994,241,230,175,119,327,3768,56,3824,5624,67.83666738
6800200-075,中壢區仁和里,668,811,198,102,97,83,210,2169,32,2201,3328,66.06999969
6800200-012,中壢區仁美里,1056,1198,266,157,142,189,247,3255,46,3301,5050,65.32666524
6800200-030,中壢區仁祥里,467,827,133,61,72,73,141,1774,42,1816,2709,67.10499954
6800200-013,中壢區仁愛里,637,599,157,100,84,83,151,1811,24,1835,2682,68.37000275
6800200-070,中壢區仁義里,860,625,188,157,128,85,215,2258,30,2288,3449,66.35499954
6800200-072,中壢區仁福里,805,1156,239,127,128,144,205,2804,31,2835,4396,64.65999858
6800200-003,中壢區仁德里,534,807,162,74,65,83,175,1900,48,1948,2936,66.39500046
6800200-027,中壢區內定里,1903,1065,250,236,169,90,360,4073,70,4143,6005,69.07749748
6800200-051,中壢區內厝里,1570,606,180,148,116,85,230,2935,52,2987,4246,70.34333293
6800200-005,中壢區內壢里,407,481,110,63,51,80,120,1312,19,1331,2054,64.81999969
6800200-034,中壢區文化里,2077,1595,424,308,249,189,490,5332,83,5415,8027,67.46199951
6800200-047,中壢區月眉里,1721,519,149,149,95,37,215,2885,40,2925,4260,68.63499832
6800200-031,中壢區水尾里,1076,624,162,107,107,82,191,2349,39,2388,3409,70.01499939
6800200-066,中壢區正義里,1022,816,201,156,164,111,265,2735,27,2762,4013,68.45000203
6800200-055,中壢區永光里,1339,912,180,201,175,139,301,3247,38,3285,4956,66.31333542
6800200-074,中壢區永福里,1491,987,223,184,182,118,333,3518,45,3563,5124,68.75
6800200-004,中壢區永興里,251,180,47,28,32,21,59,618,12,630,906,69.54000092
6800200-038,中壢區石頭里,457,324,69,49,38,40,100,1077,14,1091,1653,66
6800200-007,中壢區光明里,1241,1138,253,178,196,175,306,3487,40,3527,5110,68.99000041
6800200-006,中壢區成功里,867,835,195,119,110,117,227,2470,48,2518,3936,63.86999893
6800200-008,中壢區自立里,348,1852,272,91,86,401,262,3312,51,3363,4902,68.50333405
6800200-078,中壢區自治里,343,1031,183,71,78,176,216,2098,23,2121,3130,67.76499939
6800200-083,中壢區自信里,858,1147,261,189,169,211,306,3141,45,3186,4747,67.23666636
6800200-009,中壢區自強里,587,820,185,108,110,127,182,2119,23,2142,3135,68.36500168
6800200-063,中壢區至善里,555,856,179,95,80,103,169,2037,22,2059,3325,61.95000076
6800200-059,中壢區和平里,601,557,133,87,87,76,115,1656,29,1685,2410,69.90500259
6800200-073,中壢區幸福里,1454,1063,236,208,200,109,327,3597,40,3637,5350,67.96000163
6800200-057,中壢區忠孝里,879,892,204,166,102,111,214,2568,47,2615,4018,65.08333206
6800200-018,中壢區忠義里,740,597,161,117,96,58,160,1929,22,1951,2943,66.24500084
6800200-036,中壢區忠福里,1901,1371,358,264,219,166,446,4725,68,4793,6913,69.86250114
6800200-062,中壢區明德里,1067,881,205,178,198,133,296,2958,34,2992,4229,70.69333394
6800200-021,中壢區東興里,824,577,132,116,100,77,170,1996,29,2025,3003,68.11499977
6800200-084,中壢區林森里,869,719,181,136,111,93,215,2324,28,2352,3511,66.95999908
6800200-046,中壢區芝芭里,1023,362,89,96,68,70,157,1865,31,1896,2690,70.52500153
6800200-085,中壢區金華里,692,883,138,162,151,164,243,2433,33,2466,3546,69.44000244
6800200-032,中壢區青埔里,663,392,116,77,54,33,126,1461,23,1484,2238,66.30999756
6800200-037,中壢區信義里,947,860,196,168,170,145,294,2780,25,2805,4045,69.38000107
6800200-042,中壢區後寮里,969,835,258,123,112,100,244,2641,42,2683,4225,63.50499916
6800200-022,中壢區洽溪里,826,381,109,93,64,60,138,1671,22,1693,2537,66.86999893
6800200-052,中壢區振興里,1042,942,289,158,150,99,286,2966,44,3010,4352,69.54000092
6800200-079,中壢區健行里,1033,863,201,140,141,103,345,2826,42,2868,4182,68.85999807
6800200-077,中壢區莊敬里,378,1099,185,80,76,217,175,2210,35,2245,3218,69.61500168
6800200-056,中壢區復華里,1166,1023,239,176,130,132,301,3167,45,3212,4697,68.39666748
6800200-033,中壢區復興里,1740,1543,453,311,206,180,480,4913,58,4971,7805,63.66600189
6800200-016,中壢區普仁里,919,737,199,143,121,112,241,2472,43,2515,3873,65.19333522
6800200-060,中壢區普忠里,675,610,156,98,128,78,232,1977,25,2002,2956,67.50999832
6800200-061,中壢區普強里,719,770,157,136,149,130,286,2347,35,2382,3454,68.96500015
6800200-017,中壢區普義里,711,715,195,139,123,125,234,2242,28,2270,5214,48.08999825
6800200-053,中壢區普慶里,666,569,98,78,91,69,167,1738,32,1770,2469,71.6649971
6800200-071,中壢區華勛里,421,919,170,68,73,105,142,1898,33,1931,2837,67.95999908
6800200-076,中壢區華愛里,577,844,194,76,80,85,174,2030,34,2064,3099,66.70999908
6800200-024,中壢區新明里,1081,660,151,155,131,80,206,2464,32,2496,3631,68.69999949
6800200-014,中壢區新街里,486,380,93,61,64,61,118,1263,16,1279,1910,66.76999664
6800200-025,中壢區新興里,870,721,160,125,122,85,226,2309,29,2338,3496,66.90999985
6800200-043,中壢區過嶺里,1330,714,181,156,130,76,212,2799,50,2849,4283,66.47999954
6800200-058,中壢區福德里,591,608,124,69,101,75,169,1737,34,1771,2564,69.21500015
6800200-069,中壢區德義里,675,565,125,88,85,76,153,1767,24,1791,2572,69.58499908
6800200-023,中壢區篤行里,475,491,105,58,53,72,137,1391,21,1412,2229,63.34999847
6800200-020,中壢區興仁里,612,668,175,108,90,128,182,1963,21,1984,3104,63.84500122
6800200-080,中壢區興平里,814,441,77,98,103,53,129,1715,33,1748,2341,74.67499924
6800200-054,中壢區興和里,987,529,123,87,68,41,178,2013,37,2050,2786,73.51499939
6800200-041,中壢區興南里,647,585,123,107,101,74,174,1811,16,1827,2827,64.58499908
6800200-035,中壢區興國里,537,342,118,82,49,49,94,1271,16,1287,1886,68.23999786
6800200-001,中壢區龍平里,355,995,122,71,52,140,190,1925,43,1968,2858,69.02999878
6800200-067,中壢區龍安里,243,731,149,43,67,101,132,1466,21,1487,2060,72.19500351
6800200-029,中壢區龍岡里,797,1179,189,117,102,152,273,2809,171,2980,4274,69.84666697
6800200-002,中壢區龍昌里,981,1258,292,148,162,150,301,3292,62,3354,4996,67.35333379
6800200-039,中壢區龍東里,539,1582,254,104,112,185,262,3038,48,3086,4510,68.45999908
6800200-082,中壢區龍慈里,767,918,244,136,136,171,281,2653,39,2692,4244,63.5600001
6800200-065,中壢區龍德里,791,909,219,118,137,124,218,2516,33,2549,3683,69.34500122
6800200-011,中壢區龍興里,984,849,208,136,155,109,240,2681,30,2711,3929,69.09666697
6800200-045,中壢區舊明里,510,286,74,63,53,28,95,1109,27,1136,1508,75.33000183
6801000-015,平鎮區山峰里,503,583,107,65,30,51,133,1472,42,1514,2221,68.1400032
6801000-022,平鎮區中正里,202,471,80,54,29,75,78,989,16,1005,1463,68.69000244
6801000-040,平鎮區北安里,514,280,53,72,27,25,80,1051,13,1064,1496,71.00500107
6801000-036,平鎮區北富里,1022,676,190,126,81,89,248,2432,45,2477,3619,68.50666555
6801000-041,平鎮區北華里,853,743,147,158,121,88,236,2346,39,2385,3368,70.8599968
6801000-011,平鎮區北貴里,1043,774,186,168,106,71,226,2574,32,2606,3798,68.60500336
6801000-009,平鎮區北勢里,648,496,102,101,65,58,167,1637,22,1659,2351,70.52499771
6801000-010,平鎮區北興里,1132,741,195,155,120,69,226,2638,59,2697,3881,69.58666738
6801000-045,平鎮區平安里,1159,793,184,175,87,74,257,2729,79,2808,4075,69.0600001
6801000-046,平鎮區平南里,1351,1206,321,191,141,120,373,3703,57,3760,5620,66.8666687
6801000-043,平鎮區平興里,1013,913,290,181,146,110,307,2960,39,2999,4577,65.6299998
6801000-012,平鎮區平鎮里,1098,774,174,159,96,63,253,2617,75,2692,4091,65.56999969
6801000-006,平鎮區宋屋里,902,635,184,134,78,59,285,2277,39,2316,3490,66.26000023
6801000-021,平鎮區忠貞里,55,189,23,7,17,16,19,326,9,335,476,70.37999725
6801000-025,平鎮區東安里,477,706,134,76,53,63,145,1654,26,1680,2628,64.29000092
6801000-018,平鎮區東社里,639,828,171,84,74,92,176,2064,41,2105,3233,65.30000114
6801000-024,平鎮區東勢里,1495,901,237,152,99,69,318,3271,67,3338,4998,67.13249874
6801000-033,平鎮區金星里,1188,992,267,215,123,108,329,3222,50,3272,5051,64.44666672
6801000-039,平鎮區金陵里,654,522,137,109,90,75,170,1757,28,1785,2534,70.40000153
6801000-013,平鎮區南勢里,1385,1018,269,191,113,88,342,3406,57,3463,5182,66.82666779
6801000-023,平鎮區建安里,1199,783,195,118,105,74,231,2705,78,2783,4027,69.18666585
6801000-002,平鎮區高雙里,1219,644,176,153,115,95,216,2618,41,2659,3887,68.38999939
6801000-014,平鎮區莊敬里,811,1214,186,121,65,89,291,2777,53,2830,4192,67.52750206
6801000-003,平鎮區復旦里,1032,953,264,230,160,136,368,3143,33,3176,4763,66.4266688
6801000-042,平鎮區復興里,1201,935,228,204,141,110,349,3168,49,3217,4525,70.9399999
6801000-016,平鎮區湧光里,1215,1174,243,151,88,102,374,3347,53,3400,5032,67.66666667
6801000-030,平鎮區湧安里,942,790,217,135,76,71,255,2486,60,2546,3986,63.90666707
6801000-029,平鎮區湧豐里,415,382,85,52,35,38,112,1119,21,1140,1698,67.13999939
6801000-038,平鎮區華安里,685,1087,255,73,75,72,214,2461,61,2522,3942,64.40666707
6801000-020,平鎮區貿易里,305,535,97,55,36,82,115,1225,25,1250,1767,70.73999786
6801000-026,平鎮區新安里,760,899,243,107,62,102,251,2424,31,2455,3779,64.95999908
6801000-044,平鎮區新英里,587,663,155,135,97,119,235,1991,24,2015,3136,64.26499939
6801000-008,平鎮區新富里,1128,1003,265,257,167,163,340,3323,49,3372,5896,60.79249954
6801000-035,平鎮區新貴里,904,583,147,87,107,42,188,2058,52,2110,2981,70.86499786
6801000-007,平鎮區新勢里,1020,738,155,147,88,64,232,2444,40,2484,3509,70.73333232
6801000-037,平鎮區新榮里,1215,958,248,204,192,111,348,3276,34,3310,4685,70.99333445
6801000-005,平鎮區義民里,1062,907,204,159,143,163,314,2952,62,3014,4636,65.19666545
6801000-028,平鎮區義興里,1691,1222,289,237,167,121,416,4143,60,4203,6120,68.7650013
6801000-032,平鎮區福林里,823,626,152,101,70,76,207,2055,41,2096,2977,70.43000031
6801000-034,平鎮區廣仁里,1046,802,213,115,96,67,262,2601,38,2639,4037,65.34000015
6801000-031,平鎮區廣達里,1072,598,139,153,90,60,209,2321,38,2359,3374,69.92333221
6801000-004,平鎮區廣興里,1382,1036,242,191,149,142,310,3452,47,3499,5051,70.11749935
6801000-017,平鎮區龍恩里,440,811,122,68,55,77,174,1747,39,1786,2675,66.75499725
6801000-019,平鎮區龍興里,365,771,133,66,41,102,168,1646,36,1682,2421,69.51499939
6801000-027,平鎮區鎮興里,854,493,149,71,49,42,182,1840,43,1883,2813,67.26999664
6801000-001,平鎮區雙連里,1092,975,219,159,98,77,246,2866,58,2924,4439,66
6800100-076,桃園區三元里,820,618,162,103,61,113,195,2072,41,2113,3212,65.81499863
6800100-045,桃園區三民里,830,841,234,166,107,164,216,2558,28,2586,3828,67.4433314
6800100-057,桃園區大有里,1016,853,263,181,97,184,261,2855,34,2889,4724,61.09000015
6800100-004,桃園區大林里,2785,1595,385,422,160,173,512,6032,74,6106,9306,65.96499952
6800100-046,桃園區大興里,2455,1528,457,374,200,240,508,5762,70,5832,9318,62.59166654
6800100-043,桃園區大豐里,1403,887,217,198,131,81,260,3177,52,3229,4697,68.75666809
6800100-023,桃園區中山里,1588,1101,278,258,140,169,376,3910,47,3957,5782,68.38000107
6800100-064,桃園區中平里,1086,810,205,130,90,141,263,2725,28,2753,4181,65.94666545
6800100-030,桃園區中正里,1242,943,213,193,110,158,273,3132,42,3174,4533,70.04333242
6800100-029,桃園區中成里,1222,843,179,152,62,123,232,2813,32,2845,4158,69.05333455
6800100-020,桃園區中和里,493,201,64,54,27,29,82,950,16,966,1332,72.51999664
6800100-062,桃園區中信里,1325,953,256,181,129,162,314,3320,33,3353,5153,64.57666906
6800100-065,桃園區中原里,1003,856,221,177,111,122,243,2733,32,2765,4034,68.52499771
6800100-017,桃園區中埔里,791,313,107,98,36,35,115,1495,34,1529,2108,72.51499939
6800100-066,桃園區中泰里,828,805,212,145,91,161,252,2494,31,2525,3669,68.89999771
6800100-070,桃園區中聖里,1000,1063,245,206,115,239,273,3141,31,3172,4862,65.16333262
6800100-054,桃園區中路里,973,681,170,152,71,96,228,2371,19,2390,3618,66.09499741
6800100-049,桃園區中寧里,1263,937,267,221,116,207,307,3318,34,3352,5262,63.69666672
6800100-055,桃園區中德里,1699,1155,281,215,131,158,370,4009,42,4051,5925,68.64666748
6800100-040,桃園區中興里,1604,854,215,234,122,112,324,3465,33,3498,5052,69.20333608
6800100-052,桃園區文中里,729,536,115,96,51,51,150,1728,18,1746,2423,72.18999863
6800100-001,桃園區文化里,187,130,23,26,8,15,34,423,6,429,632,67.87999725
6800100-021,桃園區文昌里,314,135,26,34,16,15,35,575,13,588,861,68.29000092
6800100-002,桃園區文明里,400,268,58,64,40,43,72,945,9,954,1315,72.55000305
6800100-031,桃園區北門里,517,277,70,65,31,32,94,1086,16,1102,1615,68.23999786
6800100-069,桃園區北埔里,972,732,185,184,79,133,213,2498,27,2525,3900,64.74499893
6800100-008,桃園區民生里,449,263,63,73,30,40,70,988,18,1006,1429,70.40000153
6800100-011,桃園區永安里,1491,668,214,192,72,83,236,2956,39,2995,4344,68.87666829
6800100-009,桃園區永興里,583,244,66,64,36,30,105,1128,16,1144,1632,70.09999847
6800100-028,桃園區玉山里,1519,790,184,205,91,111,273,3173,45,3218,4708,68.54333242
6800100-034,桃園區光興里,1470,816,196,192,137,145,312,3268,25,3293,4603,71.59333293
6800100-050,桃園區同安里,1850,1308,361,296,122,217,348,4502,65,4567,6990,65.21999931
6800100-072,桃園區同德里,1323,1061,256,226,108,189,305,3468,34,3502,5164,67.82666779
6800100-037,桃園區成功里,1052,743,151,177,113,139,198,2573,32,2605,3691,70.57499695
6800100-061,桃園區自強里,1559,1233,354,261,137,251,339,4134,55,4189,6375,65.73500061
6800100-019,桃園區西門里,421,273,71,66,22,35,96,984,16,1000,1526,65.52999878
6800100-018,桃園區西埔里,1099,457,133,115,61,36,166,2067,38,2105,2932,72.32999802
6800100-025,桃園區西湖里,373,249,76,57,30,57,98,940,8,948,1373,69.05000305
6800100-010,桃園區汴洲里,1388,780,209,157,69,81,237,2921,43,2964,4227,70.02999878
6800100-005,桃園區忠義里,1560,1335,401,293,155,196,393,4333,62,4395,6987,62.86999989
6800100-073,桃園區明德里,718,579,153,108,53,131,147,1889,23,1912,2923,65.31499863
6800100-014,桃園區東山里,508,323,71,71,36,40,109,1158,15,1173,1796,65.30999756
6800100-013,桃園區東門里,751,532,116,132,93,79,152,1855,21,1876,2768,67.72500229
6800100-012,桃園區東埔里,1425,718,207,174,77,99,245,2945,48,2993,4455,67.34666697
6800100-003,桃園區武陵里,406,211,57,51,43,42,81,891,15,906,1444,62.74000168
6800100-016,桃園區長安里,1048,521,173,138,73,71,185,2209,37,2246,3312,67.79999924
6800100-007,桃園區長美里,367,140,38,38,26,20,46,675,21,696,971,71.68000031
6800100-063,桃園區長德里,1406,815,218,181,102,119,266,3107,57,3164,4506,70.30666606
6800100-038,桃園區青溪里,1468,741,189,210,119,101,285,3113,45,3158,4471,70.6299998
6800100-048,桃園區信光里,1789,958,309,296,119,159,381,4011,50,4061,6148,66.02750206
6800100-026,桃園區南門里,1600,1056,272,195,128,128,313,3692,45,3737,5517,67.46749878
6800100-067,桃園區南埔里,1179,765,203,171,96,111,274,2799,51,2850,4139,68.95999908
6800100-027,桃園區南華里,428,262,51,56,27,16,77,917,11,928,1344,69.05000305
6800100-042,桃園區建國里,1335,897,202,184,100,145,279,3142,44,3186,4719,67.51999919
6800100-047,桃園區春日里,1545,922,271,223,118,114,284,3477,46,3523,5586,63.06666692
6800100-053,桃園區泰山里,1023,634,190,121,94,121,234,2417,26,2443,3531,69.17499924
6800100-051,桃園區莊敬里,1667,1462,392,303,147,290,407,4668,49,4717,7327,64.40750027
6800100-039,桃園區朝陽里,580,297,95,69,36,36,91,1204,18,1222,1887,64.76000214
6800100-032,桃園區雲林里,1509,1138,284,215,128,174,320,3768,47,3815,5545,68.8200016
6800100-024,桃園區慈文里,1596,931,326,225,111,103,242,3534,54,3588,5526,64.9399999
6800100-022,桃園區新埔里,1933,1620,420,315,181,296,484,5249,68,5317,7922,67.18799896
6800100-006,桃園區會稽里,1762,1521,438,331,151,290,453,4946,54,5000,7987,62.55999947
6800100-075,桃園區瑞慶里,1228,897,283,225,82,148,279,3142,47,3189,4987,63.91333389
6800100-015,桃園區萬壽里,302,147,50,30,21,21,62,633,11,644,985,65.37999725
6800100-044,桃園區福安里,1145,756,184,160,82,123,199,2649,30,2679,3980,67.24666723
6800100-033,桃園區福林里,1562,1102,205,216,127,156,292,3660,43,3703,5312,69.70333354
6800100-035,桃園區龍山里,846,718,150,92,51,84,169,2110,62,2172,3382,64.23666763
6800100-060,桃園區龍安里,1092,846,271,192,94,118,260,2873,36,2909,4361,66.74000041
6800100-036,桃園區龍岡里,1244,1120,311,189,111,195,288,3458,48,3506,5233,66.98666636
6800100-056,桃園區龍祥里,919,947,238,145,92,135,265,2741,51,2792,4234,65.84999847
6800100-071,桃園區龍壽里,1277,886,255,194,112,98,304,3126,34,3160,4914,64.24666468
6800100-059,桃園區龍鳳里,1434,1246,352,234,170,224,369,4029,43,4072,8067,56.30249977
6800100-041,桃園區豐林里,1824,1112,277,228,127,183,320,4071,57,4128,5953,69.38750076
6800100-058,桃園區寶山里,1704,1295,442,288,143,216,363,4451,62,4513,7246,62.18250179
6800100-074,桃園區寶安里,1631,1266,409,232,128,216,368,4250,49,4299,6921,62.11999989
6800100-068,桃園區寶慶里,1231,1004,273,261,130,189,293,3381,40,3421,5173,66.03999837
6801300-001,復興區三民里,431,364,88,30,19,18,117,1067,44,1111,1815,61.20999908
6801300-006,復興區三光里,51,158,46,3,3,2,43,306,9,315,570,55.25999832
6801300-005,復興區長興里,58,134,28,6,5,3,46,280,18,298,573,52.00999832
6801300-007,復興區奎輝里,43,160,35,3,3,6,51,301,6,307,581,52.84000015
6801300-010,復興區高義里,57,130,34,13,2,7,51,294,21,315,612,51.47000122
6801300-008,復興區華陵里,183,215,56,6,3,27,53,543,26,569,1078,52.77999878
6801300-003,復興區義盛里,31,212,42,5,1,4,57,352,10,362,620,58.38999939
6801300-002,復興區澤仁里,169,316,68,10,8,26,91,688,30,718,1226,58.56000137
6801300-004,復興區霞雲里,23,187,26,5,0,5,39,285,5,290,492,58.93999863
6801300-009,復興區羅浮里,109,255,57,12,5,7,58,503,6,509,888,57.31999969
6801100-007,新屋區九斗里,763,350,108,59,33,31,123,1467,32,1499,2188,68.42500305
6801100-012,新屋區下田里,620,276,62,49,17,18,85,1127,32,1159,1656,69.98999786
6801100-011,新屋區下埔里,245,110,20,13,7,4,38,437,11,448,655,68.40000153
6801100-022,新屋區大坡里,469,204,43,37,15,13,72,853,26,879,1259,69.81999969
6801100-016,新屋區永安里,799,397,105,49,24,25,112,1511,38,1549,2209,69.70999908
6801100-015,新屋區永興里,338,147,33,22,16,10,47,613,27,640,929,68.88999939
6801100-013,新屋區石牌里,310,154,42,21,6,15,54,602,26,628,876,71.69000244
6801100-010,新屋區石磊里,665,296,69,57,30,14,96,1227,41,1268,1863,68.05999756
6801100-014,新屋區赤欄里,445,257,65,15,17,19,73,891,13,904,1266,71.41000366
6801100-009,新屋區東明里,442,275,76,41,16,12,72,934,20,954,1369,69.69000244
6801100-008,新屋區社子里,551,211,47,44,19,24,85,981,16,997,1313,75.93000031
6801100-021,新屋區後庄里,332,198,45,29,13,23,71,711,30,741,1039,71.31999969
6801100-003,新屋區後湖里,475,257,62,50,24,19,65,952,32,984,1413,69.63999939
6801100-006,新屋區埔頂里,788,481,110,94,43,36,124,1676,47,1723,2458,70.08000183
6801100-023,新屋區望間里,595,206,41,31,11,11,73,968,28,996,1405,70.88999939
6801100-018,新屋區深圳里,201,109,55,8,6,10,43,432,21,453,649,69.80000305
6801100-004,新屋區清華里,1108,658,179,98,59,57,191,2350,58,2408,3569,67.3599968
6801100-017,新屋區笨港里,324,200,34,25,11,12,60,666,27,693,986,70.27999878
6801100-019,新屋區蚵間里,296,121,23,24,7,8,67,546,13,559,863,64.76999664
6801100-002,新屋區新生里,1104,760,192,138,63,51,162,2470,56,2526,3672,68.82999802
6801100-001,新屋區新屋里,823,538,131,108,40,54,122,1816,43,1859,2687,69.39500046
6801100-020,新屋區槺榔里,385,160,35,28,11,16,60,695,23,718,1047,68.58000183
6801100-005,新屋區頭洲里,1251,675,124,95,70,48,195,2458,65,2523,3577,70.68500137
6800400-040,楊梅區三民里,576,640,189,128,39,67,156,1795,38,1833,2980,61.71999931
6800400-024,楊梅區三湖里,701,522,133,67,22,37,132,1614,36,1650,2488,66.35499954
6800400-008,楊梅區上田里,747,445,126,91,36,22,161,1628,36,1664,2452,68.00999832
6800400-025,楊梅區上湖里,1156,843,260,158,61,94,280,2852,82,2934,4689,62.55999947
6800400-005,楊梅區大平里,757,673,157,106,48,67,212,2020,48,2068,3125,66.16500092
6800400-010,楊梅區大同里,764,782,155,109,55,60,177,2102,36,2138,3071,69.63500214
6800400-026,楊梅區中山里,598,618,131,114,52,63,164,1740,38,1778,2696,66.13999939
6800400-018,楊梅區仁美里,928,900,174,142,76,102,232,2554,56,2610,3796,68.79333242
6800400-007,楊梅區水美里,1007,835,183,152,52,63,222,2514,77,2591,3851,67.25666809
6800400-014,楊梅區四維里,802,884,229,178,92,95,205,2485,39,2524,3747,67.36500168
6800400-035,楊梅區永平里,384,348,96,67,32,39,96,1062,22,1084,1719,63.06000137
6800400-004,楊梅區永寧里,1396,1109,305,194,82,106,342,3534,47,3581,6100,59.01333364
6800400-019,楊梅區光華里,647,839,171,82,56,88,173,2056,42,2098,3095,67.81499863
6800400-030,楊梅區秀才里,832,639,148,146,54,70,200,2089,55,2144,3073,69.80500031
6800400-006,楊梅區東流里,785,446,111,79,30,48,148,1647,40,1687,2601,64.77999878
6800400-028,楊梅區金溪里,619,609,186,157,97,165,308,2141,28,2169,3212,66.6799984
6800400-012,楊梅區金龍里,145,329,65,26,13,55,59,692,7,699,1046,66.83000183
6800400-031,楊梅區青山里,686,630,197,89,56,78,169,1905,39,1944,3410,56.98999977
6800400-003,楊梅區紅梅里,641,596,131,98,44,43,139,1692,31,1723,2538,67.85499954
6800400-022,楊梅區員本里,721,478,141,79,43,26,133,1621,42,1663,2442,68.06000137
6800400-011,楊梅區埔心里,449,315,51,51,22,29,103,1020,22,1042,1425,73.12000275
6800400-037,楊梅區高上里,701,488,150,69,39,37,179,1663,34,1697,2463,68.77000046
6800400-016,楊梅區高山里,714,639,190,122,52,64,226,2007,119,2126,3392,62.7650013
6800400-017,楊梅區高榮里,972,541,136,100,69,63,156,2037,46,2083,2981,69.75500107
6800400-009,楊梅區梅新里,437,467,94,90,35,25,132,1280,33,1313,1902,69.02999878
6800400-015,楊梅區梅溪里,649,671,162,116,53,73,180,1904,24,1928,3192,60.43000031
6800400-020,楊梅區富岡里,443,422,92,71,24,26,104,1182,38,1220,1757,69.44000244
6800400-038,楊梅區富豐里,745,479,152,58,32,39,184,1689,48,1737,2689,65.06500244
6800400-032,楊梅區新榮里,900,715,147,138,76,48,198,2222,26,2248,3232,69.90999985
6800400-002,楊梅區楊江里,255,274,54,35,19,13,71,721,19,740,1075,68.83999634
6800400-027,楊梅區楊明里,983,1011,268,209,95,118,296,2980,48,3028,4612,65.75
6800400-001,楊梅區楊梅里,828,856,178,135,58,73,209,2337,38,2375,3453,68.84999847
6800400-034,楊梅區瑞坪里,977,1050,312,190,86,135,279,3029,44,3073,4977,61.69999949
6800400-023,楊梅區瑞原里,956,723,184,119,45,59,199,2285,57,2342,3612,65.06500053
6800400-013,楊梅區瑞塘里,1136,863,207,155,75,105,267,2808,57,2865,4365,65.58000056
6800400-036,楊梅區瑞溪里,644,544,144,124,58,65,166,1745,30,1775,2884,61.22999763
6800400-029,楊梅區裕成里,538,657,195,114,63,116,215,1898,25,1923,2902,66.43999863
6800400-039,楊梅區裕新里,361,359,124,59,27,50,128,1108,17,1125,1962,57.34000015
6800400-041,楊梅區頭湖里,553,461,168,87,30,31,169,1499,36,1535,2431,63.82999992
6800400-021,楊梅區豐野里,953,711,179,123,49,55,252,2322,54,2376,3511,67.67500305
6800400-033,楊梅區雙榮里,820,596,134,92,73,77,150,1942,31,1973,2820,70.45999908
6800900-013,龍潭區九龍里,750,729,182,112,42,85,196,2096,55,2151,3371,63.78499985
6800900-007,龍潭區八德里,966,754,182,79,68,60,233,2342,55,2397,3772,63.41333389
6800900-008,龍潭區三水里,297,86,25,10,7,6,45,476,22,498,657,75.80000305
6800900-017,龍潭區三坑里,484,213,59,29,13,33,96,927,19,946,1436,65.87999725
6800900-016,龍潭區三和里,547,372,78,79,60,109,151,1396,29,1425,2040,69.52500153
6800900-019,龍潭區三林里,507,598,109,100,80,177,255,1826,30,1856,2671,69.50500107
6800900-009,龍潭區上林里,1029,701,186,139,58,87,271,2471,56,2527,3896,64.60000038
6800900-026,龍潭區上華里,570,684,176,71,52,117,220,1890,23,1913,2897,66.03499985
6800900-018,龍潭區大平里,527,326,92,53,39,77,133,1247,16,1263,1943,65
6800900-002,龍潭區中山里,1231,999,209,164,76,142,314,3135,46,3181,4556,69.85666656
6800900-010,龍潭區中正里,951,990,213,164,100,120,354,2892,35,2927,4435,66.06499863
6800900-014,龍潭區中興里,848,936,191,116,53,112,282,2538,54,2592,4035,64.25
6800900-029,龍潭區北興里,383,513,119,57,27,46,141,1286,35,1321,2189,60.57500076
6800900-020,龍潭區永興里,642,548,141,78,38,59,173,1679,48,1727,2696,64.18499947
6800900-022,龍潭區百年里,520,939,207,119,92,250,347,2474,30,2504,3681,68
6800900-015,龍潭區佳安里,531,789,143,83,66,195,284,2091,29,2120,3079,69.68333181
6800900-028,龍潭區東興里,574,1028,201,113,68,132,272,2388,46,2434,3822,63.46000099
6800900-027,龍潭區武漢里,642,524,116,56,29,54,144,1565,25,1590,2560,61.875
6800900-030,龍潭區建林里,611,863,157,102,81,267,322,2403,32,2435,3508,69.43000031
6800900-006,龍潭區凌雲里,791,714,182,96,38,55,217,2093,46,2139,3345,63.94499779
6800900-003,龍潭區烏林里,853,807,174,116,61,63,200,2274,46,2320,3685,62.92000008
6800900-021,龍潭區烏樹林里,614,397,109,75,38,35,162,1430,38,1468,2165,67.93000031
6800900-004,龍潭區高平里,827,481,165,82,44,50,212,1861,46,1907,2904,65.65500259
6800900-012,龍潭區高原里,1021,624,218,134,64,85,298,2444,53,2497,3933,63.63499832
6800900-031,龍潭區富林里,611,842,130,103,80,152,276,2194,34,2228,3321,67.45000076
6800900-001,龍潭區黃唐里,953,806,235,143,73,91,307,2608,58,2666,4137,64.74666595
6800900-024,龍潭區聖德里,728,499,144,91,45,51,193,1751,31,1782,2858,62.30999947
6800900-025,龍潭區龍星里,914,881,161,144,64,107,245,2516,47,2563,4125,62.04000092
6800900-023,龍潭區龍祥里,761,778,154,81,40,54,216,2084,45,2129,3345,63.96000099
6800900-011,龍潭區龍潭里,579,405,82,82,34,41,126,1349,20,1369,1860,73.52999878
6800700-004,龜山區大同里,1485,966,226,212,87,143,274,3393,53,3446,5265,65.64750099
6800700-012,龜山區大坑里,606,290,75,86,22,10,99,1188,37,1225,1779,68.86000061
6800700-019,龜山區大崗里,1006,641,182,115,60,57,192,2253,49,2302,3469,66.35499954
6800700-027,龜山區大湖里,1137,735,245,179,89,169,233,2787,35,2822,4434,63.88499832
6800700-028,龜山區大華里,2027,1179,417,333,156,202,412,4726,72,4798,7385,64.81999969
6800700-006,龜山區山頂里,1314,972,242,214,90,87,252,3171,45,3216,5043,63.89333216
6800700-005,龜山區山福里,888,597,121,94,55,59,156,1970,22,1992,2973,66.98000336
6800700-014,龜山區山德里,1379,854,212,169,88,97,281,3080,52,3132,4727,66.27666728
6800700-013,龜山區中興里,1273,794,233,176,77,120,243,2916,44,2960,4484,65.87666702
6800700-009,龜山區公西里,335,263,56,34,14,36,45,783,18,801,1112,72.02999878
6800700-020,龜山區文化里,1507,850,305,216,104,150,272,3404,41,3445,5290,65.12666829
6800700-003,龜山區兔坑里,1076,718,196,138,45,64,201,2438,58,2496,3954,64.68333308
6800700-022,龜山區幸福里,1145,844,234,139,78,81,283,2804,68,2872,4824,59.63999939
6800700-029,龜山區長庚里,888,416,139,261,108,70,186,2068,16,2084,3105,67.24000168
6800700-011,龜山區南上里,558,291,89,91,38,17,99,1183,32,1215,1716,70.80000305
6800700-021,龜山區南美里,624,405,95,83,33,32,122,1394,25,1419,2101,67.54000092
6800700-025,龜山區迴龍里,1429,853,271,230,94,101,280,3258,54,3312,5108,64.78999964
6800700-007,龜山區陸光里,158,1377,202,69,48,359,196,2409,46,2455,3496,70.22499847
6800700-015,龜山區新路里,1574,994,267,222,114,134,258,3563,73,3636,5215,69.95750046
6800700-030,龜山區新興里,431,566,100,62,30,96,94,1379,22,1401,2748,50.09999847
6800700-026,龜山區新嶺里,1065,581,179,134,52,70,201,2282,39,2321,3687,63.24499893
6800700-001,龜山區楓樹里,1706,893,256,212,100,119,310,3596,65,3661,5119,71.45333099
6800700-023,龜山區福源里,503,385,102,51,40,30,107,1218,22,1240,1926,64.37999725
6800700-008,龜山區精忠里,981,1330,273,174,81,338,270,3447,52,3499,5266,67.48000081
6800700-010,龜山區樂善里,981,527,163,105,56,43,167,2042,41,2083,3287,63.40000153
6800700-024,龜山區龍華里,899,561,122,105,44,69,180,1980,26,2006,3022,66.27999878
6800700-017,龜山區龍壽里,644,216,70,60,21,24,73,1108,18,1126,1643,68.52999878
6800700-002,龜山區龜山里,1784,1162,268,231,99,154,346,4044,61,4105,6213,65.5350008
6800700-016,龜山區嶺頂里,1158,573,174,127,47,54,186,2319,43,2362,3700,64.05666606
6800700-018,龜山區舊路里,820,369,99,88,33,74,138,1621,36,1657,2299,72.04499817
6800500-022,蘆竹區上竹里,978,602,146,128,63,54,173,2144,36,2180,3127,69.72999954
6800500-037,蘆竹區上興里,904,509,133,131,69,84,159,1989,23,2012,2885,70.1099968
6800500-004,蘆竹區大竹里,1182,709,178,144,61,100,230,2604,28,2632,3808,69.12999725
6800500-012,蘆竹區山腳里,1256,536,139,127,66,43,211,2378,84,2462,3435,71.70999908
6800500-011,蘆竹區山鼻里,590,311,72,58,29,15,134,1209,33,1242,1788,69.45999908
6800500-033,蘆竹區中山里,618,478,134,91,33,88,108,1550,16,1566,2589,60.27499962
6800500-002,蘆竹區中福里,1351,444,123,115,56,34,202,2325,36,2361,3269,72.15000153
6800500-036,蘆竹區中興里,1027,610,180,154,72,71,177,2291,30,2321,3619,64.63500023
6800500-009,蘆竹區五福里,559,415,93,74,47,71,150,1409,20,1429,2177,65.62999916
6800500-010,蘆竹區內厝里,783,364,79,75,26,32,119,1478,45,1523,2396,63.98500061
6800500-013,蘆竹區外社里,659,185,47,39,27,7,78,1042,38,1080,1386,77.91999817
6800500-024,蘆竹區瓦窯里,617,528,113,94,47,65,152,1616,29,1645,2615,63.75
6800500-032,蘆竹區吉祥里,764,558,173,133,72,159,161,2020,28,2048,3006,68.12000275
6800500-026,蘆竹區羊稠里,984,672,156,149,103,157,216,2437,34,2471,3748,65.96999931
6800500-015,蘆竹區坑口里,952,343,70,82,36,19,138,1640,39,1679,2289,73.25499725
6800500-014,蘆竹區坑子里,744,175,55,50,14,14,112,1164,32,1196,1624,73.65000153
6800500-023,蘆竹區宏竹里,1095,400,107,98,62,55,130,1947,43,1990,2785,71.54000092
6800500-031,蘆竹區長壽里,1086,997,251,192,117,174,281,3098,38,3136,4745,66.02333577
6800500-019,蘆竹區長興里,675,371,120,85,20,29,132,1432,37,1469,2430,60.74999809
6800500-007,蘆竹區南崁里,905,619,121,125,69,85,200,2124,30,2154,3153,68.05500031
6800500-017,蘆竹區南榮里,811,524,117,115,65,107,139,1878,22,1900,2906,65.34000015
6800500-018,蘆竹區南興里,1063,800,247,162,87,166,250,2775,35,2810,4311,65.20500183
6800500-016,蘆竹區海湖里,1423,826,238,117,53,68,367,3092,95,3187,4964,64.23666636
6800500-021,蘆竹區富竹里,565,137,35,55,35,14,91,932,15,947,1259,75.22000122
6800500-027,蘆竹區順興里,766,480,156,119,40,97,148,1806,32,1838,2977,61.69499969
6800500-003,蘆竹區新莊里,1488,610,196,145,62,70,225,2796,56,2852,4195,67.95666758
6800500-001,蘆竹區新興里,1184,373,110,101,45,32,170,2015,33,2048,2788,73.50999832
6800500-028,蘆竹區福昌里,1048,765,227,178,90,150,253,2711,44,2755,4380,62.88500023
6800500-034,蘆竹區福祿里,729,488,123,122,57,70,156,1745,18,1763,2776,63.57999992
6800500-029,蘆竹區福興里,1696,1082,352,258,124,186,373,4071,58,4129,6782,60.91250038
6800500-035,蘆竹區興榮里,627,537,101,105,56,69,119,1614,24,1638,2446,67
6800500-020,蘆竹區錦中里,861,496,134,121,59,94,177,1942,37,1979,2926,67.75500107
6800500-008,蘆竹區錦興里,1064,616,163,148,84,47,203,2325,45,2370,3442,68.86499786
6800500-038,蘆竹區營福里,738,479,162,105,58,71,144,1757,19,1776,2766,64.20999908
6800500-025,蘆竹區營盤里,974,695,209,148,93,128,249,2496,38,2534,3981,63.74500084
6800500-006,蘆竹區蘆竹里,1635,519,136,125,65,45,210,2735,62,2797,3832,73.00500107
6800500-030,蘆竹區蘆興里,520,288,66,64,26,30,96,1090,43,1133,1540,73.56999969
6801200-007,觀音區三和里,310,164,36,18,16,6,38,588,15,603,836,72.12999725
6801200-016,觀音區上大里,728,336,108,59,45,25,117,1418,38,1456,2160,67.3900032
6801200-012,觀音區大同里,1001,411,106,101,76,14,156,1865,40,1905,2808,67.90500259
6801200-013,觀音區大堀里,543,185,47,44,22,18,70,929,15,944,1365,69.16000366
6801200-004,觀音區大潭里,503,237,75,51,21,19,85,991,20,1011,1511,66.91000366
6801200-002,觀音區白玉里,352,215,25,33,18,13,54,710,24,734,1034,70.98999786
6801200-009,觀音區坑尾里,492,237,53,46,20,22,81,951,29,980,1475,66.44000244
6801200-005,觀音區武威里,325,143,32,19,19,9,47,594,14,608,823,73.87999725
6801200-010,觀音區金湖里,810,357,113,68,31,31,128,1538,46,1584,2411,65.75
6801200-006,觀音區保生里,659,318,95,57,20,22,125,1296,28,1324,1955,68.60000229
6801200-020,觀音區保障里,740,231,79,70,20,11,106,1257,40,1297,1894,68.47999954
6801200-024,觀音區草新里,1352,736,234,165,69,61,249,2866,49,2915,4579,63.74000041
6801200-021,觀音區草漯里,576,195,71,53,13,7,123,1038,31,1069,1591,67.19000244
6801200-014,觀音區崙坪里,1634,708,164,192,87,55,266,3106,72,3178,4493,70.9433314
6801200-023,觀音區富林里,591,243,98,62,20,19,109,1142,29,1171,1808,64.76999664
6801200-015,觀音區富源里,1002,570,170,115,70,56,185,2168,52,2220,3427,64.88499832
6801200-019,觀音區塔腳里,340,170,43,23,11,5,56,648,23,671,998,67.23000336
6801200-017,觀音區新坡里,1056,391,91,93,52,24,136,1843,38,1881,2744,68.55999756
6801200-008,觀音區新興里,261,99,29,20,10,12,53,484,9,493,708,69.62999725
6801200-018,觀音區廣福里,882,252,105,81,39,24,115,1498,45,1543,2208,69.84500122
6801200-003,觀音區廣興里,425,232,81,30,20,9,87,884,32,916,1348,67.94999695
6801200-022,觀音區樹林里,846,460,150,70,27,29,166,1748,52,1800,3079,58.5
6801200-011,觀音區藍埔里,854,323,112,78,36,25,151,1579,31,1610,2332,69.04499817
6801200-001,觀音區觀音里,817,479,80,77,35,27,126,1641,45,1686,2567,65.5
6601100-002,大甲區大甲里,300,181,38,45,18,32,83,697,14,711,996,71.38999939
6601100-009,大甲區中山里,1006,826,195,158,65,80,281,2611,64,2675,4097,65.34666697
6601100-021,大甲區太白里,399,216,25,39,5,13,103,800,33,833,1242,67.06999969
6601100-004,大甲區孔門里,180,158,22,42,6,13,38,459,10,469,782,59.97000122
6601100-014,大甲區文曲里,363,174,35,43,9,5,85,714,23,737,1103,66.81999969
6601100-016,大甲區文武里,1418,962,185,263,89,85,367,3369,56,3425,5012,68.35750008
6601100-024,大甲區日南里,1401,844,199,226,78,54,282,3084,91,3175,5025,63.2225008
6601100-005,大甲區平安里,612,384,82,115,28,33,117,1371,39,1410,2011,70.46499634
6601100-006,大甲區庄美里,637,361,86,110,24,34,129,1381,27,1408,2056,68.33499908
6601100-019,大甲區江南里,379,234,64,53,20,19,95,864,22,886,1289,68.73999786
6601100-026,大甲區西岐里,433,348,45,67,17,22,115,1047,44,1091,1608,67.93999863
6601100-017,大甲區奉化里,491,350,79,101,27,52,127,1227,35,1262,1879,67.08499908
6601100-022,大甲區孟春里,1183,624,115,156,45,36,234,2393,75,2468,3757,65.73666636
6601100-008,大甲區岷山里,521,401,89,101,28,40,124,1304,33,1337,2011,66.54999924
6601100-023,大甲區幸福里,863,369,68,101,22,23,173,1619,62,1681,2527,66.71999741
6601100-015,大甲區武曲里,468,350,68,82,25,23,135,1151,41,1192,1707,69.79499817
6601100-013,大甲區武陵里,266,248,47,39,13,14,80,707,31,738,1123,65.72000122
6601100-010,大甲區南陽里,197,159,33,31,11,19,56,506,13,519,785,66.11000061
6601100-029,大甲區建興里,529,222,37,40,7,5,102,942,42,984,1411,69.73999786
6601100-020,大甲區頂店里,1272,711,153,223,65,74,257,2755,89,2844,4137,68.59666697
6601100-001,大甲區朝陽里,384,265,61,71,26,19,88,914,20,934,1344,69.48999786
6601100-003,大甲區順天里,467,286,60,64,30,17,102,1026,23,1049,1518,69.09000015
6601100-007,大甲區新美里,917,697,100,137,57,41,225,2174,54,2228,3247,68.65666707
6601100-012,大甲區義和里,796,567,90,157,45,42,200,1897,45,1942,2993,64.875
6601100-028,大甲區福德里,306,198,47,33,6,17,79,686,34,720,1055,68.25
6601100-027,大甲區銅安里,399,199,46,49,10,16,89,808,32,840,1306,64.31999969
6601100-018,大甲區德化里,576,239,58,74,15,13,96,1071,31,1102,1674,66.05999947
6601100-025,大甲區龍泉里,430,287,61,49,12,7,109,955,42,997,1497,66.76499939
6601100-011,大甲區薰風里,263,183,26,30,15,17,56,590,20,610,861,70.84999847
6602200-003,大安區中庄里,685,431,109,99,26,38,182,1570,45,1615,2550,63.33499908
6602200-008,大安區永安里,497,352,40,64,18,22,115,1108,45,1153,1703,68.02499771
6602200-011,大安區西安里,499,318,51,66,15,18,108,1075,38,1113,1667,67.06000137
6602200-006,大安區東安里,348,243,39,48,12,16,85,791,30,821,1192,68.87999725
6602200-012,大安區松雅里,280,164,14,44,8,5,56,571,23,594,820,72.44000244
6602200-002,大安區南庄里,310,171,22,33,7,4,62,609,36,645,1030,62.61999893
6602200-001,大安區南埔里,355,184,24,25,4,8,73,673,20,693,1030,67.27999878
6602200-010,大安區海墘里,316,365,44,62,17,13,80,897,43,940,1381,68.06999969
6602200-007,大安區頂安里,279,162,24,29,9,10,62,575,23,598,874,68.41999817
6300300-017,大安區福住里,275,168,48,35,10,16,60,612,37,649,1009,64.31999969
6602200-005,大安區福興里,403,186,44,54,12,5,82,786,31,817,1170,69.83000183
6602200-004,大安區龜壳里,413,305,47,86,8,18,134,1011,41,1052,1571,66.48500252
6602400-008,大肚區大肚里,549,518,62,98,24,26,124,1401,38,1439,1928,74.38499832
6602400-007,大肚區大東里,807,637,141,142,33,68,156,1984,60,2044,2858,71.64499664
6602400-013,大肚區山陽里,393,275,60,51,15,16,113,923,36,959,1284,74.69000244
6602400-002,大肚區中和里,287,137,47,34,11,17,74,607,26,633,840,75.36000061
6602400-001,大肚區王田里,1243,804,196,211,49,34,266,2803,109,2912,4044,71.94666799
6602400-009,大肚區永和里,238,207,32,32,9,22,51,591,17,608,821,74.05999756
6602400-011,大肚區永順里,493,319,67,91,12,17,108,1107,58,1165,1577,73.87000275
6602400-012,大肚區成功里,236,220,56,51,10,9,72,654,27,681,919,74.09999847
6602400-017,大肚區自強里,883,755,185,126,45,101,228,2323,54,2377,3375,70.42499924
6602400-005,大肚區社腳里,627,519,135,96,44,55,164,1640,54,1694,2345,72.34999847
6602400-014,大肚區頂街里,1821,1337,366,314,97,146,484,4565,120,4685,6608,71.1724987
6602400-006,大肚區新興里,689,556,157,82,30,59,170,1743,68,1811,2520,71.85000229
6602400-015,大肚區瑞井里,1409,828,299,207,42,83,334,3202,90,3292,4617,71.10000102
6602400-003,大肚區福山里,1089,699,169,166,38,57,251,2469,93,2562,3504,73.08333333
6602400-016,大肚區蔗廍里,1342,691,209,212,44,78,343,2919,91,3010,4422,67.97000122
6602400-004,大肚區營埔里,381,301,93,71,12,15,105,978,54,1032,1397,73.87000275
6602400-010,大肚區磺溪里,436,341,78,73,23,17,110,1078,40,1118,1587,70.44999695
6602800-012,大里區大元里,1376,576,229,219,63,78,238,2779,34,2813,3986,70.3799998
6602800-001,大里區大里里,1042,499,203,164,37,60,223,2228,55,2283,3338,68.54000092
6602800-022,大里區大明里,1149,677,195,180,56,75,225,2557,40,2597,3936,65.91333389
6602800-025,大里區中新里,1242,748,309,253,87,119,297,3055,49,3104,4743,65.58333333
6602800-014,大里區仁化里,2452,1106,433,351,120,106,462,5030,90,5120,7927,64.70500088
6602800-027,大里區仁德里,1714,914,273,270,88,99,324,3682,72,3754,5666,66.31666565
6602800-008,大里區內新里,2011,1263,447,368,132,170,492,4883,75,4958,7659,64.82000046
6602800-006,大里區日新里,1113,626,239,193,47,78,226,2522,52,2574,3670,70.26999919
6602800-023,大里區永隆里,2306,1450,403,461,171,245,561,5597,72,5669,8027,70.62250137
6602800-010,大里區立仁里,1384,736,262,243,53,95,306,3079,61,3140,4901,64.12000148
6602800-026,大里區立德里,2160,1020,400,382,89,107,366,4524,81,4605,6885,66.84250069
6602800-020,大里區西湖里,822,416,174,138,46,32,179,1807,36,1843,2653,69.49499893
6602800-007,大里區西榮里,1543,844,267,257,97,105,348,3461,61,3522,5369,65.63666789
6602800-009,大里區東昇里,903,529,133,161,47,70,191,2034,39,2073,3102,66.83499908
6602800-019,大里區東湖里,2611,1484,628,427,114,214,601,6079,108,6187,9341,66.25333277
6602800-004,大里區東興里,1948,1085,415,365,155,117,447,4532,69,4601,6752,68.13249779
6602800-018,大里區金城里,2572,1431,539,390,84,177,532,5725,77,5802,9031,64.12799911
6602800-024,大里區長榮里,2146,1308,491,501,162,205,502,5315,61,5376,7843,68.59000015
6602800-013,大里區夏田里,331,137,57,59,21,12,69,686,26,712,974,73.09999847
6602800-015,大里區健民里,1207,664,275,141,46,58,257,2648,74,2722,4157,65.1533343
6602800-021,大里區國光里,1517,921,306,276,128,134,414,3696,56,3752,5397,69.51750183
6602800-005,大里區祥興里,1971,972,327,321,82,122,417,4212,68,4280,6523,65.77599945
6602800-016,大里區塗城里,2456,1181,423,344,93,108,464,5069,101,5170,7922,65.26499844
6602800-011,大里區新仁里,2270,1092,387,328,79,135,413,4704,85,4789,7177,66.82250023
6602800-002,大里區新里里,2543,1405,456,435,172,184,522,5717,104,5821,9047,63.97600098
6602800-017,大里區瑞城里,3069,1743,629,538,139,213,674,7005,121,7126,10880,65.51857158
6602800-003,大里區樹王里,1130,465,144,179,47,52,195,2212,51,2263,3200,70.74499893
6601800-010,大雅區二和里,1541,1109,258,338,80,91,353,3770,83,3853,5467,70.52333323
6601800-007,大雅區三和里,1489,894,263,268,77,59,294,3344,83,3427,4682,73.22000122
6601800-012,大雅區上雅里,1412,984,269,308,55,115,314,3457,86,3543,5164,68.8100001
6601800-009,大雅區上楓里,1722,986,263,340,75,95,372,3853,86,3939,5516,71.42666626
6601800-001,大雅區大雅里,1175,891,223,215,59,74,265,2902,62,2964,4148,71.44666545
6601800-014,大雅區大楓里,1294,806,236,235,53,68,311,3003,96,3099,4430,69.93333181
6601800-003,大雅區六寶里,1441,1342,319,267,66,111,380,3926,108,4034,5823,69.31749916
6601800-013,大雅區文雅里,1414,1160,297,304,76,146,334,3731,73,3804,5521,68.91000112
6601800-011,大雅區四德里,1169,791,206,261,64,78,257,2826,46,2872,4118,69.82333374
6601800-008,大雅區西寶里,1425,756,215,227,61,75,268,3027,62,3089,4398,70.26333364
6601800-004,大雅區秀山里,1024,556,144,163,33,48,211,2179,81,2260,3003,75.26000214
6601800-005,大雅區忠義里,469,1186,206,90,20,166,200,2337,86,2423,3539,68.42500305
6601800-002,大雅區員林里,2524,1635,376,489,109,151,572,5856,154,6010,8293,72.38166682
6601800-015,大雅區雅楓里,853,666,170,155,54,51,240,2189,68,2257,3363,67.26000023
6601800-006,大雅區橫山里,1176,722,170,224,53,60,289,2694,103,2797,3834,72.94999949
6600100-007,中區大誠里,607,401,107,93,23,45,125,1401,38,1439,2169,66.25500107
6600100-002,中區大墩里,602,367,102,101,28,45,107,1352,18,1370,2089,65.4600029
6600100-008,中區中華里,462,271,77,80,20,39,108,1057,14,1071,1735,61.72999954
6600100-004,中區公園里,408,226,78,59,15,37,99,922,9,931,1499,62.11000061
6600100-005,中區光復里,561,386,89,72,31,55,109,1303,19,1322,2018,65.46999741
6600100-006,中區柳川里,436,302,77,69,22,50,83,1039,24,1063,1815,59.96499825
6600100-003,中區綠川里,523,268,71,77,42,41,86,1108,24,1132,1636,69.18499756
6600100-001,中區繼光里,451,265,66,63,14,30,80,969,17,986,1485,66.40000153
6602700-035,太平區大興里,672,391,98,97,34,59,150,1501,41,1542,2409,64.20499992
6602700-008,太平區中山里,682,670,143,113,43,109,154,1914,38,1952,3578,55.55999947
6602700-003,太平區中平里,1255,644,174,160,57,47,227,2564,43,2607,3913,66.64500046
6602700-024,太平區中政里,1032,536,176,160,31,48,210,2193,59,2252,3498,64.37499809
6602700-004,太平區中興里,1122,514,159,172,37,37,177,2218,48,2266,3278,69.15999985
6602700-001,太平區太平里,1860,814,256,244,69,68,343,3654,69,3723,5288,70.26333364
6602700-025,太平區平安里,707,369,109,133,28,29,144,1519,28,1547,2155,71.71500015
6602700-021,太平區永平里,1096,594,177,184,50,82,207,2390,57,2447,3730,65.62999725
6602700-020,太平區永成里,1806,934,295,266,70,90,332,3793,94,3887,6028,64.4666659
6602700-039,太平區永隆里,767,410,130,105,20,19,160,1611,49,1660,2406,68.95499802
6602700-033,太平區光明里,776,767,190,141,45,114,238,2271,49,2320,3563,65.09500122
6602700-010,太平區光華里,1217,928,242,202,68,139,296,3092,57,3149,4729,66.58999888
6602700-017,太平區光隆里,974,431,136,100,28,40,191,1900,46,1946,2914,66.79499817
6602700-022,太平區成功里,1105,530,198,160,31,47,173,2244,46,2290,3562,64.64999962
6602700-009,太平區坪林里,718,728,162,123,45,112,162,2050,37,2087,3081,67.77500153
6602700-031,太平區宜佳里,1426,957,319,258,81,128,329,3498,81,3579,5632,63.60333252
6602700-032,太平區宜昌里,1066,567,197,161,49,59,191,2290,30,2320,3607,64.5
6602700-007,太平區宜欣里,1790,935,283,260,70,149,331,3818,57,3875,5850,66.19000053
6602700-006,太平區東平里,1090,629,178,195,41,58,206,2397,42,2439,3773,64.59999847
6602700-015,太平區東汴里,393,179,36,23,6,6,70,713,37,750,1155,64.94000244
6602700-023,太平區東和里,717,450,112,108,30,32,150,1599,44,1643,2558,64.34000015
6602700-002,太平區長億里,1569,968,286,272,81,104,336,3616,56,3672,5450,67.42666626
6602700-005,太平區建國里,817,542,116,100,35,60,130,1800,50,1850,2763,66.86999893
6602700-026,太平區建興里,714,578,119,130,20,31,187,1779,33,1812,2808,64.15500069
6602700-019,太平區黃竹里,214,123,33,19,6,8,37,440,28,468,662,70.69000244
6602700-036,太平區勤益里,463,511,101,73,42,70,144,1404,29,1433,2087,68.66999817
6602700-012,太平區新光里,2008,1029,359,341,91,133,385,4346,78,4424,6441,68.65749931
6602700-029,太平區新吉里,1308,910,309,218,66,142,266,3219,51,3270,4899,66.76333237
6602700-011,太平區新坪里,1637,1152,429,299,99,153,381,4150,83,4233,6549,64.50500011
6602700-030,太平區新城里,1141,798,222,206,64,97,257,2785,55,2840,4647,61.13000107
6602700-028,太平區新高里,1270,741,253,251,67,114,260,2956,55,3011,4589,65.7100029
6602700-013,太平區新福里,1368,906,275,265,48,160,309,3331,62,3393,5121,66.12333552
6602700-027,太平區新興里,1068,559,204,198,74,98,266,2467,32,2499,3722,67.15000153
6602700-037,太平區聖和里,451,225,83,47,16,32,103,957,18,975,1536,63.47999954
6602700-038,太平區福隆里,945,639,174,136,45,49,231,2219,36,2255,3357,67.07500076
6602700-018,太平區德隆里,1379,645,231,218,37,64,307,2881,71,2952,4504,65.83666738
6602700-016,太平區興隆里,909,625,168,100,35,42,188,2067,43,2110,3129,67.46999741
6602700-014,太平區頭汴里,552,325,71,45,15,21,112,1141,40,1181,1805,65.43000031
6602700-034,太平區豐年里,1122,864,209,190,81,107,273,2846,56,2902,4175,69.50499725
6600800-003,北屯區三光里,1624,1227,335,299,134,272,434,4325,67,4392,6561,67.15250015
6600800-041,北屯區三和里,1396,1075,262,289,100,177,362,3661,44,3705,5478,67.81000137
6600800-014,北屯區大坑里,621,310,105,77,24,59,110,1306,36,1342,2016,66.56999969
6600800-031,北屯區大德里,1022,996,290,215,86,200,322,3131,52,3183,4683,67.96000163
6600800-017,北屯區仁和里,1844,1295,362,393,131,208,494,4727,52,4779,8140,62.34999943
6600800-018,北屯區仁美里,1925,1286,373,364,107,182,452,4689,58,4747,6808,69.74750137
6600800-022,北屯區仁愛里,265,227,51,54,21,38,61,717,15,732,1104,66.30000305
6600800-008,北屯區水景里,3470,2074,546,684,199,381,764,8118,121,8239,11966,68.94571577
6600800-023,北屯區水湳里,1634,1178,300,264,90,218,404,4088,76,4164,6091,68.14500046
6600800-002,北屯區北屯里,795,590,168,157,81,126,199,2116,21,2137,3199,66.79999924
6600800-034,北屯區北京里,867,555,170,132,57,125,186,2092,25,2117,3092,68.50999832
6600800-001,北屯區北興里,847,639,167,140,50,96,186,2125,37,2162,3153,68.61000061
6600800-019,北屯區四民里,474,309,67,86,16,27,96,1075,35,1110,1543,71.94000244
6600800-035,北屯區平心里,1074,807,257,210,85,132,285,2850,31,2881,4465,64.60666784
6600800-004,北屯區平田里,1187,978,283,287,98,227,330,3390,67,3457,5186,66.59999847
6600800-026,北屯區平安里,1294,898,266,278,97,165,301,3299,49,3348,5003,66.76000214
6600800-005,北屯區平和里,1052,878,283,250,89,199,323,3074,40,3114,4760,65.44666545
6600800-040,北屯區平昌里,1032,801,216,192,57,144,239,2681,45,2726,4182,65.21999995
6600800-038,北屯區平陽里,1129,838,273,229,87,171,261,2988,39,3027,4516,66.99666595
6600800-027,北屯區平順里,776,499,157,145,66,106,178,1927,28,1955,2970,65.75499916
6600800-036,北屯區平福里,790,740,169,162,62,154,219,2296,34,2330,3408,68.19499969
6600800-028,北屯區平德里,1488,1006,291,320,132,232,336,3805,44,3849,5812,66.21666972
6600800-039,北屯區平興里,1413,1056,360,319,93,175,390,3806,61,3867,5916,65.36250114
6600800-012,北屯區民政里,315,150,29,25,6,33,54,612,18,630,974,64.68000031
6600800-015,北屯區民德里,270,141,59,26,6,20,65,587,15,602,903,66.66999817
6600800-021,北屯區同榮里,1313,993,291,255,88,185,313,3438,48,3486,4988,69.85333506
6600800-020,北屯區后庄里,1960,1872,559,423,180,389,584,5967,93,6060,8764,69.30399933
6600800-010,北屯區和平里,2279,1358,363,421,106,173,534,5234,96,5330,7814,68.38399963
6600800-042,北屯區忠平里,819,780,232,190,62,149,248,2480,43,2523,3722,67.81999969
6600800-011,北屯區東山里,712,303,79,81,33,32,133,1373,27,1400,1962,71.36000061
6600800-006,北屯區東光里,1172,772,225,222,44,102,293,2830,50,2880,4327,66.38333257
6600800-029,北屯區松安里,1190,873,221,259,71,137,290,3041,40,3081,4505,68.40333303
6600800-016,北屯區松竹里,1833,1473,389,418,168,303,518,5102,70,5172,7556,68.53600159
6600800-037,北屯區松和里,1485,995,349,274,84,189,354,3730,56,3786,6067,62.41999912
6600800-033,北屯區松勇里,1238,914,304,300,91,160,316,3323,49,3372,4835,69.99333445
6600800-030,北屯區松茂里,1152,944,273,247,112,218,320,3266,49,3315,4879,67.93000031
6600800-032,北屯區松強里,1398,1024,321,308,83,183,312,3629,46,3675,5657,64.99500084
6600800-009,北屯區軍功里,3054,1845,495,570,175,271,676,7086,123,7209,10330,69.81714412
6600800-024,北屯區陳平里,1062,767,221,185,60,164,284,2743,38,2781,4201,66.1166687
6600800-025,北屯區新平里,904,862,219,166,48,140,244,2583,51,2634,4086,64.84666824
6600800-013,北屯區廍子里,1374,972,289,316,80,155,307,3493,46,3539,5364,66.66000112
6600800-007,北屯區舊社里,1517,1035,304,283,68,125,371,3703,72,3775,5640,66.99400024
6600500-028,北區大湖里,673,302,89,81,26,45,121,1337,25,1362,2163,63.44499969
6600500-026,北區中正里,450,227,65,77,21,26,95,961,21,982,1457,67.40000153
6600500-019,北區中達里,734,446,116,115,36,70,175,1692,31,1723,2525,68.18000031
6600500-003,北區五常里,416,160,67,83,13,30,73,842,4,846,1287,65.73000336
6600500-027,北區六合里,542,258,82,60,20,31,93,1086,22,1108,1715,64.61000061
6600500-002,北區文莊里,638,776,203,135,49,209,214,2224,44,2268,3322,68.29000092
6600500-034,北區立人里,662,623,179,174,73,178,273,2162,35,2197,3359,65.45000076
6600500-001,北區光大里,549,315,90,79,32,44,120,1229,39,1268,1995,63.57999992
6600500-017,北區育德里,882,561,176,170,51,127,250,2217,29,2246,3353,67.11000061
6600500-033,北區明新里,731,469,146,119,34,92,194,1785,23,1808,2669,67.65499878
6600500-022,北區明德里,1300,926,216,242,96,191,376,3347,48,3395,5012,67.7533315
6600500-012,北區邱厝里,511,415,71,101,40,86,153,1377,11,1388,2050,67.8350029
6600500-010,北區金華里,531,401,103,110,46,123,173,1487,17,1504,2244,66.99000168
6600500-011,北區金龍里,1061,774,225,171,56,162,258,2707,29,2736,4231,64.69999949
6600500-023,北區長青里,1424,996,284,300,108,180,436,3728,41,3769,5713,66.02500057
6600500-008,北區建成里,1343,861,280,227,70,123,327,3231,52,3283,5079,64.62333298
6600500-030,北區建德里,892,643,173,157,38,99,228,2230,51,2281,3291,69.40499878
6600500-013,北區建興里,1480,900,318,281,102,162,388,3631,49,3680,5525,66.63399963
6600500-021,北區健行里,1755,994,270,288,113,177,457,4054,58,4112,6022,68.35250092
6600500-031,北區崇德里,868,582,165,166,68,122,208,2179,25,2204,3286,67.03499985
6600500-035,北區梅川里,674,525,169,180,62,118,191,1919,28,1947,2889,67.41999817
6600500-018,北區淡溝里,1244,769,204,236,95,161,384,3093,41,3134,4644,67.61333211
6600500-014,北區頂厝里,971,702,218,195,89,164,274,2613,34,2647,3916,67.33000056
6600500-005,北區新北里,461,300,65,72,44,67,104,1113,22,1135,1756,65.21000099
6600500-004,北區新興里,365,287,84,44,13,60,69,922,23,945,1528,61.80999947
6600500-006,北區樂英里,327,702,171,77,25,259,179,1740,33,1773,2692,65.67000198
6600500-016,北區賴村里,1249,737,198,196,81,113,302,2876,31,2907,4312,67.53333537
6600500-032,北區賴旺里,990,711,214,211,79,118,250,2573,47,2620,4145,63
6600500-024,北區賴明里,827,676,172,193,70,110,237,2285,36,2321,3576,64.76999919
6600500-015,北區賴厝里,841,712,190,202,89,119,264,2417,33,2450,4867,53.22999954
6600500-036,北區賴福里,895,662,183,171,66,135,271,2383,29,2412,3536,68.15499878
6600500-025,北區賴興里,816,707,194,185,54,144,259,2359,35,2394,3630,66.23666763
6600500-029,北區錦平里,520,320,70,83,24,69,104,1190,24,1214,1885,64.44999886
6600500-007,北區錦村里,827,619,158,179,54,137,213,2187,30,2217,3080,72.01499939
6600500-009,北區錦洲里,744,641,172,140,56,117,218,2088,23,2111,3147,66.66999817
6600500-020,北區錦祥里,788,633,203,175,54,130,254,2237,24,2261,3416,66.54499817
6602100-003,外埔區三崁里,436,352,62,102,13,26,171,1162,32,1194,1842,64.81999969
6602100-010,外埔區土城里,487,306,57,69,17,11,171,1118,35,1153,1593,72.37999725
6602100-004,外埔區大同里,1044,940,162,181,48,76,329,2780,85,2865,4241,67.3799998
6602100-006,外埔區大東里,1484,1267,243,246,67,93,399,3799,101,3900,5875,66.40500069
6602100-008,外埔區中山里,295,272,40,52,9,13,85,766,33,799,1110,71.98000336
6602100-002,外埔區六分里,473,457,90,97,33,37,151,1338,47,1385,2022,68.38499832
6602100-005,外埔區水美里,796,661,98,141,33,44,213,1986,67,2053,3171,64.53666687
6602100-001,外埔區永豐里,251,203,32,38,9,14,78,625,28,653,982,66.5
6602100-007,外埔區馬鳴里,363,284,56,57,7,40,97,904,40,944,1341,70.40000153
6602100-011,外埔區廍子里,320,223,48,59,28,6,113,797,44,841,1208,69.62000275
6602100-009,外埔區鐵山里,483,422,96,91,20,39,156,1307,45,1352,2109,64.01000214
6602000-003,石岡區九房里,387,260,39,43,24,17,76,846,25,871,1193,73.01000214
6602000-008,石岡區土牛里,267,223,53,32,14,18,62,669,23,692,981,70.54000092
6602000-001,石岡區石岡里,366,232,55,46,10,26,80,815,21,836,1179,70.91000366
6602000-010,石岡區和盛里,290,315,58,45,9,25,78,820,20,840,1187,70.76999664
6602000-004,石岡區金星里,401,234,61,38,13,16,69,832,33,865,1242,69.65000153
6602000-007,石岡區梅子里,508,343,90,77,26,40,107,1191,38,1229,1763,69.70999908
6602000-002,石岡區萬安里,437,316,58,57,19,21,96,1004,21,1025,1400,73.20999908
6602000-006,石岡區萬興里,412,295,61,74,12,24,113,991,34,1025,1396,73.41999817
6602000-009,石岡區德興里,359,315,77,59,19,30,110,969,29,998,1441,69.26000214
6602000-005,石岡區龍興里,196,135,33,21,6,3,44,438,16,454,640,70.94000244
6601500-010,后里區中和里,613,383,87,119,33,39,408,1682,43,1725,2320,74.27999878
6601500-002,后里區仁里里,238,217,54,44,14,9,129,705,28,733,999,73.37000275
6601500-016,后里區公館里,556,308,77,105,27,39,281,1393,52,1445,2035,70.99499893
6601500-013,后里區太平里,493,366,85,120,38,26,270,1398,60,1458,2087,69.81999969
6601500-017,后里區月眉里,525,265,65,79,26,18,220,1198,29,1227,1697,72.30000305
6601500-004,后里區后里里,874,735,138,179,54,68,416,2464,66,2530,3465,72.95666758
6601500-005,后里區厚里里,577,436,90,111,26,43,238,1521,55,1576,2043,77.19499969
6601500-014,后里區眉山里,718,591,129,179,39,56,361,2073,61,2134,3006,70.99499893
6601500-015,后里區泰安里,385,177,54,65,19,9,152,861,28,889,1239,71.75
6601500-003,后里區義里里,613,764,147,129,39,77,281,2050,50,2100,2959,70.93500137
6601500-018,后里區義德里,532,618,116,122,24,32,304,1748,50,1798,2561,70.34499741
6601500-009,后里區墩北里,841,621,124,189,56,61,472,2364,63,2427,3265,74.34499741
6601500-007,后里區墩西里,518,369,73,99,25,18,232,1334,40,1374,1870,73.10000229
6601500-006,后里區墩東里,1139,986,189,238,59,78,546,3235,80,3315,4486,73.94666545
6601500-008,后里區墩南里,864,627,118,206,33,36,359,2243,58,2301,3056,75.25499725
6601500-001,后里區廣福里,316,543,97,75,11,29,178,1249,44,1293,1867,69.72000122
6601500-012,后里區聯合里,439,268,51,79,14,21,196,1068,44,1112,1536,72.40000153
6601500-011,后里區舊社里,502,310,69,113,22,15,326,1357,35,1392,1892,73.56999969
6600600-006,西屯區上石里,1029,782,275,213,72,126,245,2742,45,2787,4360,64.00666682
6600600-027,西屯區上安里,1034,787,229,252,92,160,309,2863,36,2899,4476,64.76666514
6600600-028,西屯區上德里,992,726,232,203,85,156,260,2654,54,2708,3904,69.38666534
6600600-012,西屯區大石里,115,795,137,43,21,199,115,1425,28,1453,2175,66.63000107
6600600-011,西屯區大河里,1237,580,187,181,52,109,220,2566,32,2598,3614,71.79000092
6600600-013,西屯區大福里,748,635,156,151,28,127,169,2014,46,2060,3082,66.78000259
6600600-014,西屯區大鵬里,1124,934,240,191,65,137,261,2952,57,3009,4466,67.63666662
6600600-018,西屯區永安里,2602,1963,564,578,195,346,734,6982,128,7110,11139,64.43714305
6600600-026,西屯區至善里,966,726,204,219,95,137,264,2611,41,2652,3896,68.04333242
6600600-024,西屯區西平里,953,1041,286,194,83,136,338,3031,52,3083,4673,65.84666697
6600600-001,西屯區西安里,1233,762,205,266,106,105,333,3010,50,3060,4403,69.51666768
6600600-002,西屯區西墩里,1291,720,204,224,72,85,290,2886,56,2942,4296,68.53999837
6600600-021,西屯區何仁里,1610,971,289,333,110,140,395,3848,47,3895,5841,66.68250084
6600600-009,西屯區何安里,1304,838,200,269,92,116,304,3123,51,3174,4831,65.71333567
6600600-031,西屯區何成里,1619,1090,365,331,150,250,524,4329,66,4395,6631,66.32999992
6600600-030,西屯區何明里,1000,628,159,185,105,93,239,2409,31,2440,3547,68.76333364
6600600-025,西屯區何南里,999,745,218,237,109,143,276,2727,36,2763,3987,69.31333415
6600600-010,西屯區何厝里,868,506,172,153,49,71,163,1982,34,2016,2988,67.45000076
6600600-023,西屯區何源里,1513,1135,327,356,125,230,412,4098,64,4162,6227,66.86750031
6600600-032,西屯區何福里,1173,717,219,252,92,135,308,2896,47,2943,4139,71.04666646
6600600-022,西屯區何德里,958,594,182,195,51,84,230,2294,30,2324,3449,67.34000015
6600600-020,西屯區協和里,1187,628,195,174,54,48,280,2566,75,2641,3891,67.42333476
6600600-017,西屯區林厝里,900,576,164,154,55,84,213,2146,49,2195,3126,70.18000031
6600600-007,西屯區逢甲里,990,760,205,173,72,115,252,2567,46,2613,3999,65.6200002
6600600-029,西屯區逢福里,1210,1023,254,266,87,163,317,3320,61,3381,4915,68.74999746
6600600-005,西屯區惠來里,2443,2002,578,549,260,448,760,7040,89,7129,11086,64.34571511
6600600-015,西屯區港尾里,1349,817,267,210,69,114,315,3141,45,3186,4477,71.17666626
6600600-034,西屯區福中里,807,525,147,166,79,93,191,2008,43,2051,3009,68.0850029
6600600-019,西屯區福安里,659,477,116,120,49,101,168,1690,29,1719,2431,70.81999969
6600600-033,西屯區福和里,1302,596,176,245,69,69,282,2739,46,2785,3892,71.57999929
6600600-038,西屯區福林里,1348,1201,322,359,169,319,541,4259,49,4308,6456,66.73249817
6600600-035,西屯區福恩里,647,490,142,193,59,92,218,1841,18,1859,2730,68.13499832
6600600-035,西屯區福恩里、協和里,444,309,84,87,38,68,138,1168,15,1183,1738,68.06999969
6600600-039,西屯區福雅里,1194,997,264,278,105,148,355,3341,56,3397,5064,66.7533315
6600600-037,西屯區福瑞里,502,438,158,124,55,130,186,1593,26,1619,2685,60.14999962
6600600-036,西屯區福聯里,577,429,128,99,53,90,168,1544,29,1573,2724,57.78499985
6600600-016,西屯區廣福里,882,364,85,138,27,38,142,1676,33,1709,2307,73.91500092
6600600-003,西屯區潮洋里,1075,671,217,194,73,136,292,2658,50,2708,4729,57.44666545
6600600-004,西屯區龍潭里,343,120,31,37,5,15,46,597,7,604,814,74.19999695
6600600-008,西屯區鵬程里,174,997,179,58,31,196,142,1777,36,1813,2687,67.49499893
6600400-003,西區三民里,376,315,51,59,46,78,140,1065,5,1070,2122,53.59999847
6600400-018,西區土庫里,1499,930,257,269,116,163,348,3582,64,3646,5298,68.76666768
6600400-025,西區大忠里,1050,762,208,239,79,150,293,2781,37,2818,4008,70.74333445
6600400-021,西區中興里,1109,632,140,157,74,86,257,2455,34,2489,3533,70.44000244
6600400-022,西區公平里,1135,824,218,220,114,118,298,2927,33,2960,4550,65.06999842
6600400-017,西區公正里,1564,981,302,321,143,204,386,3901,48,3949,5683,69.5549984
6600400-007,西區公民里,1239,756,210,206,104,141,294,2950,37,2987,4433,67.39333344
6600400-020,西區公益里,853,471,164,159,56,61,142,1906,20,1926,2720,70.82500076
6600400-023,西區公德里,1053,708,202,190,94,131,277,2655,23,2678,3978,67.30000051
6600400-009,西區公舘里,1541,871,273,255,99,132,330,3501,52,3553,5252,67.94250011
6600400-024,西區双龍里,684,549,126,142,52,84,170,1807,32,1839,2731,67.37999725
6600400-006,西區平和里,434,330,82,85,45,69,167,1212,15,1227,1876,65.54000092
6600400-001,西區民生里,448,318,87,99,50,70,129,1201,15,1216,1802,67.43500137
6600400-011,西區民龍里,721,551,143,155,50,106,196,1922,38,1960,3090,63.84499741
6600400-014,西區吉龍里,1574,1119,282,334,170,225,446,4150,66,4216,6206,67.93499947
6600400-013,西區安龍里,779,467,105,133,50,80,195,1809,23,1832,2758,66.43000031
6600400-002,西區利民里,320,288,64,64,39,74,104,953,13,966,1385,69.75
6600400-010,西區和龍里,707,323,102,98,24,51,137,1442,23,1465,2259,64.88499832
6600400-016,西區忠明里,1445,881,239,274,86,169,392,3486,58,3544,5447,65.11666616
6600400-019,西區忠誠里,1522,952,237,302,125,162,382,3682,46,3728,5541,67.19249916
6600400-015,西區昇平里,1535,891,271,287,111,180,339,3614,62,3676,5425,67.73500061
6600400-004,西區東昇里,607,418,82,121,47,70,176,1521,19,1540,2178,70.64999771
6600400-012,西區後龍里,913,551,151,177,63,85,214,2154,47,2201,3299,66.72500229
6600400-005,西區廣民里,371,286,56,63,35,48,108,967,20,987,1498,65.88999939
6600400-008,西區藍興里,1067,650,187,180,76,125,298,2583,34,2617,3767,69.55333455
6601300-021,沙鹿區三鹿里,1466,1010,384,313,79,110,395,3757,141,3898,5695,68.46999868
6601300-017,沙鹿區公明里,807,984,235,159,46,91,297,2619,81,2700,3968,67.97666423
6601300-014,沙鹿區六路里,1149,720,244,218,68,67,316,2782,86,2868,4259,67.35666656
6601300-006,沙鹿區斗抵里,1263,811,232,190,57,74,278,2905,86,2991,4127,72.46999868
6601300-011,沙鹿區北勢里,1205,797,254,266,68,87,290,2967,97,3064,4386,69.83666738
6601300-009,沙鹿區竹林里,1834,1310,319,293,108,144,460,4468,157,4625,6742,68.85999934
6601300-019,沙鹿區西勢里,523,435,121,94,25,25,142,1365,79,1444,2075,69.59000015
6601300-003,沙鹿區沙鹿里,345,159,51,50,19,14,58,696,20,716,961,74.51000214
6601300-001,沙鹿區居仁里,401,267,58,71,20,28,97,942,29,971,1353,71.76999664
6601300-015,沙鹿區南勢里,835,508,160,131,39,55,284,2012,98,2110,3027,69.76499939
6601300-002,沙鹿區洛泉里,548,455,86,127,41,43,145,1445,46,1491,2000,74.20000076
6601300-004,沙鹿區美仁里,137,110,51,21,2,12,28,361,11,372,497,74.84999847
6601300-016,沙鹿區埔子里,1172,897,265,226,89,92,339,3080,148,3228,4554,70.99666595
6601300-013,沙鹿區晉江里,493,272,98,76,13,26,104,1082,47,1129,1559,72.41999817
6601300-018,沙鹿區清泉里,502,501,138,95,21,59,146,1462,35,1497,2163,69.27500153
6601300-010,沙鹿區犁分里,357,153,38,41,11,17,59,676,29,705,1007,70.01000214
6601300-007,沙鹿區鹿峰里,1508,807,165,248,78,43,288,3137,92,3229,4665,69.04333242
6601300-008,沙鹿區鹿寮里,2075,1052,281,334,134,83,368,4327,125,4452,6236,71.34799957
6601300-012,沙鹿區福興里,847,658,208,147,38,61,257,2216,85,2301,3229,71.31999969
6601300-005,沙鹿區興仁里,683,440,110,110,35,47,177,1602,57,1659,2310,71.75500107
6601300-020,沙鹿區興安里,966,612,170,152,42,35,215,2192,79,2271,3157,71.875
6602900-004,和平區中坑里,102,124,22,10,1,12,35,306,11,317,425,74.58999634
6602900-002,和平區天輪里,94,91,24,8,1,8,18,244,13,257,436,58.93999863
6602900-008,和平區平等里,90,187,84,12,0,25,44,442,12,454,786,55.04999924
6602900-005,和平區自由里,96,316,100,23,6,10,82,633,17,650,998,64.9166654
6602900-001,和平區南勢里,391,414,104,43,16,27,149,1144,37,1181,1805,65.43999863
6602900-007,和平區梨山里,235,351,129,19,5,22,59,820,26,846,1832,47.32000097
6602900-003,和平區博愛里,233,363,165,29,14,21,130,955,16,971,1554,61.73500061
6602900-006,和平區達觀里,172,292,87,20,12,21,74,678,21,699,1028,68.77999878
6600200-010,東區十甲里,1291,693,206,217,56,78,257,2798,47,2845,4121,69.10333506
6600200-005,東區干城里,755,338,94,124,31,68,149,1559,24,1583,2300,68.65499878
6600200-013,東區合作里,685,1024,216,162,49,170,248,2554,63,2617,3959,65.93666712
6600200-007,東區旱溪里,788,402,107,109,32,57,164,1659,36,1695,2399,70.41500092
6600200-009,東區東門里,2203,784,268,338,97,89,384,4163,77,4240,5887,72.09500122
6600200-016,東區東信里,2780,1296,395,444,131,161,519,5726,111,5837,8216,71.16600189
6600200-011,東區東南里,997,659,205,180,56,81,201,2379,41,2420,3588,67.48000081
6600200-017,東區東英里,1959,981,298,366,95,144,410,4253,81,4334,6172,70.43999863
6600200-012,東區東勢里,671,430,153,127,47,85,154,1667,34,1701,2600,65.43499756
6600200-003,東區東橋里,1277,473,135,172,50,62,200,2369,40,2409,3473,69.37333171
6600200-004,東區東興里,937,421,145,145,51,60,180,1939,29,1968,2761,71.20999908
6600200-006,東區泉源里,577,237,66,71,29,40,113,1133,16,1149,1660,69.34999847
6600200-002,東區振興里,1058,463,122,145,42,62,203,2095,40,2135,3098,68.96333313
6600200-015,東區富仁里,636,1031,217,154,73,281,214,2606,44,2650,4025,66.45666758
6600200-014,東區富台里,300,434,105,47,18,109,93,1106,30,1136,1686,67.50999832
6600200-001,東區新庄里,868,413,108,148,46,73,137,1793,35,1828,2979,62.14666621
6600200-008,東區樂成里,732,284,92,98,32,38,114,1390,20,1410,2037,69.22000122
6601000-014,東勢區上城里,330,200,31,31,11,15,60,678,27,705,977,72.16000366
6601000-006,東勢區上新里,230,249,44,28,19,30,83,683,18,701,954,73.48000336
6601000-015,東勢區下城里,272,167,33,30,6,14,61,583,31,614,865,70.98000336
6601000-020,東勢區下新里,472,306,68,67,17,33,129,1092,47,1139,1648,69.11000061
6601000-009,東勢區中嵙里,459,360,94,56,26,50,133,1178,44,1222,1855,65.875
6601000-002,東勢區中寧里,183,187,52,38,9,20,55,544,24,568,810,70.12000275
6601000-001,東勢區北興里,235,331,76,48,17,28,91,826,18,844,1297,65.06999969
6601000-005,東勢區延平里,579,500,116,89,29,47,183,1543,25,1568,2261,69.41500092
6601000-025,東勢區明正里,379,244,66,39,10,10,83,831,39,870,1322,65.80999756
6601000-003,東勢區東安里,241,279,40,35,15,32,80,722,15,737,1036,71.13999939
6601000-018,東勢區東新里,412,481,99,84,27,39,135,1277,30,1307,1855,70.48500061
6601000-004,東勢區南平里,398,489,111,66,29,56,135,1284,41,1325,1828,72.56500244
6601000-022,東勢區茂興里,470,352,68,68,23,16,123,1120,37,1157,1729,66.78000259
6601000-008,東勢區泰昌里,697,836,172,136,52,103,262,2258,86,2344,3333,70.27999878
6601000-023,東勢區泰興里,221,145,28,24,11,8,45,482,25,507,720,70.41999817
6601000-024,東勢區埤頭里,266,129,27,29,5,13,49,518,17,535,664,80.56999969
6601000-013,東勢區詒福里,479,314,62,55,12,18,124,1064,49,1113,1590,70
6601000-011,東勢區隆興里,343,267,82,37,17,29,106,881,46,927,1449,63.97999954
6601000-012,東勢區新盛里,1307,1010,218,199,48,65,375,3222,101,3323,4814,68.94000244
6601000-019,東勢區粵寧里,561,417,99,83,22,41,107,1330,48,1378,1958,70.50999832
6601000-010,東勢區福隆里,773,783,200,134,39,74,266,2269,74,2343,3411,68.59666697
6601000-007,東勢區廣興里,300,362,46,48,21,48,108,933,27,960,1374,69.87000275
6601000-016,東勢區慶東里,596,274,87,41,23,33,145,1199,51,1250,1814,68.90499878
6601000-017,東勢區慶福里,386,182,56,45,13,20,105,807,39,846,1320,64.08999634
6601000-021,東勢區興隆里,392,205,42,56,11,12,95,813,20,833,1169,71.26000214
6600700-024,南屯區三和里,1534,1438,404,400,187,257,487,4707,59,4766,7044,67.47833379
6600700-010,南屯區三厝里,1511,1038,300,325,118,171,446,3909,55,3964,5794,68.38599854
6600700-025,南屯區三義里,1265,1082,294,320,140,225,388,3714,28,3742,5612,66.66399994
6600700-015,南屯區大同里,1264,711,230,289,117,120,322,3053,31,3084,4444,69.40999985
6600700-021,南屯區大業里,1454,1090,298,345,140,223,426,3976,48,4024,5942,67.76750183
6600700-019,南屯區大誠里,839,562,170,170,85,114,238,2178,33,2211,3221,68.64999898
6600700-020,南屯區大興里,1122,676,225,224,81,98,226,2652,59,2711,3841,70.57333374
6600700-004,南屯區中和里,1389,702,255,238,64,69,298,3015,68,3083,4307,71.59333293
6600700-007,南屯區文山里,2160,1320,448,464,113,144,542,5191,88,5279,8184,64.47999878
6600700-016,南屯區文心里,826,590,186,169,63,126,263,2223,42,2265,3328,68.04000092
6600700-009,南屯區永定里,1353,664,210,242,62,108,282,2921,50,2971,4367,68.06666819
6600700-012,南屯區田心里,1613,1026,281,330,132,125,393,3900,50,3950,5591,70.66749763
6600700-017,南屯區同心里,1150,839,266,238,96,160,340,3089,42,3131,4755,65.95750141
6600700-018,南屯區向心里,1070,725,227,190,79,112,272,2675,35,2710,4593,60.7366689
6600700-001,南屯區南屯里,2171,1348,399,444,155,229,504,5250,67,5317,7773,68.35000229
6600700-006,南屯區春安里,129,218,29,21,6,17,41,461,12,473,718,65.87999725
6600700-005,南屯區春社里,1369,1145,307,248,71,141,358,3639,94,3733,5979,62.76999969
6600700-022,南屯區惠中里,1583,1171,365,353,126,214,424,4236,50,4286,6281,68.16199951
6600700-008,南屯區新生里,365,127,63,34,11,21,64,685,12,697,968,72
6600700-003,南屯區楓樹里,1610,942,258,272,104,112,329,3627,80,3707,5187,71.60750008
6600700-011,南屯區溝墘里,1285,895,217,246,137,171,318,3269,41,3310,4643,71.28750038
6600700-013,南屯區黎明里,966,963,223,167,74,227,297,2917,31,2948,4148,71.06500053
6600700-002,南屯區豐樂里,2889,1681,511,494,221,293,651,6740,86,6826,9666,70.82499981
6600700-014,南屯區鎮平里,551,179,72,71,19,19,122,1033,20,1053,1481,71.46500015
6600700-023,南屯區寶山里,1284,749,256,220,84,108,310,3011,42,3053,4614,66.10750008
6600300-021,南區工學里,1420,968,319,330,119,197,385,3738,47,3785,5665,66.88666534
6600300-018,南區平和里,1056,535,171,210,77,93,247,2389,40,2429,3428,70.85000229
6600300-020,南區永和里,1102,651,200,212,88,122,299,2674,43,2717,4157,65.51499939
6600300-011,南區永興里,1745,1159,378,365,149,189,410,4395,57,4452,6634,67.03499985
6600300-006,南區江川里,827,463,122,157,60,70,196,1895,20,1915,2665,71.49000168
6600300-014,南區西川里,1014,661,204,194,81,114,305,2573,40,2613,3894,67.18500137
6600300-010,南區和平里,922,520,192,185,52,85,249,2205,33,2238,3549,63.11000061
6600300-015,南區長春里,585,381,83,99,35,48,120,1351,17,1368,1947,70.21500015
6600300-016,南區長榮里,724,473,120,117,50,66,157,1707,22,1729,2438,71
6600300-019,南區南和里,1346,1029,317,316,107,197,397,3709,54,3763,6299,60.58333333
6600300-003,南區南門里,987,609,150,160,81,94,254,2335,21,2356,3370,70.03499985
6600300-001,南區城隍里,1008,623,164,166,64,83,223,2331,37,2368,3488,68.02499771
6600300-002,南區國光里,1162,667,143,195,83,92,223,2565,46,2611,3776,69.05500031
6600300-022,南區崇倫里,1408,844,243,265,112,155,339,3366,47,3413,4927,69.35666911
6600300-007,南區新榮里,959,659,193,214,87,143,276,2531,50,2581,3983,64.94499969
6600300-009,南區福平里,1401,850,205,254,92,104,328,3234,52,3286,4915,66.85999807
6600300-017,南區福順里,1309,821,238,255,106,157,332,3218,39,3257,4895,66.77666473
6600300-008,南區福興里,1072,682,186,174,54,94,232,2494,37,2531,3590,70.52999878
6600300-004,南區德義里,733,492,134,156,70,94,173,1852,18,1870,2695,69.60499954
6600300-012,南區樹義里,2397,1594,480,484,158,204,620,5937,92,6029,9194,65.38000031
6600300-013,南區樹德里,1896,1288,390,382,138,218,507,4819,69,4888,7075,69.42799988
6600300-005,南區積善里,797,378,95,146,40,77,187,1720,28,1748,2520,69.36999893
6602300-006,烏日區九德里,3667,2165,626,582,192,248,813,8293,130,8423,12004,70.32000078
6602300-003,烏日區三和里,986,942,235,164,53,57,248,2685,72,2757,4019,68.8100001
6602300-009,烏日區五光里,509,235,119,50,16,22,141,1092,33,1125,1571,71.61000061
6602300-007,烏日區仁德里,1966,1342,349,375,135,153,380,4700,76,4776,6829,69.92749977
6602300-014,烏日區北里里,535,233,75,61,14,18,191,1127,36,1163,1553,74.88999939
6602300-010,烏日區光明里,719,366,109,118,25,25,138,1500,41,1541,2108,73.1400032
6602300-011,烏日區東園里,687,326,120,86,28,28,117,1392,42,1434,1914,74.91999817
6602300-008,烏日區前竹里,902,320,124,86,16,24,152,1624,43,1667,2226,75.05500031
6602300-015,烏日區南里里,382,232,83,64,14,18,115,908,41,949,1234,76.90000153
6602300-001,烏日區烏日里,2443,1319,405,396,124,189,499,5375,90,5465,7729,70.83600006
6602300-002,烏日區湖日里,781,408,147,124,42,27,157,1686,39,1725,2440,70.68499756
6602300-016,烏日區溪尾里,212,110,83,20,8,14,54,501,27,528,805,65.58999634
6602300-012,烏日區溪埧里,1345,783,271,198,43,60,306,3006,89,3095,4176,73.99333445
6602300-004,烏日區榮泉里,910,770,209,183,48,60,233,2413,82,2495,3752,66.52000046
6602300-005,烏日區學田里,609,472,130,106,18,49,146,1530,43,1573,2290,68.6649971
6602300-013,烏日區螺潭里,631,354,114,81,35,37,119,1371,31,1402,1910,73.40000153
6601600-007,神岡區三角里,963,393,92,120,22,22,146,1758,35,1793,2418,74.13999939
6601600-009,神岡區大社里,1251,687,207,185,54,76,226,2686,63,2749,3966,69.17666372
6601600-016,神岡區山皮里,341,149,54,47,15,11,66,683,29,712,941,75.66000366
6601600-003,神岡區北庄里,844,477,103,147,25,35,162,1793,54,1847,2493,74.125
6601600-013,神岡區圳前里,703,518,104,103,30,29,144,1631,62,1693,2260,74.83000183
6601600-015,神岡區圳堵里,568,461,85,102,26,23,137,1402,51,1453,1964,74.42499924
6601600-002,神岡區庄前里,651,400,70,107,27,25,164,1444,44,1488,1985,75.01499939
6601600-004,神岡區庄後里,736,356,94,117,26,21,160,1510,42,1552,2034,76.28499985
6601600-008,神岡區岸裡里,1102,468,99,122,35,42,155,2023,38,2061,2747,75.01000214
6601600-005,神岡區社口里,2241,1130,297,408,90,94,479,4739,109,4848,6744,71.86600037
6601600-006,神岡區社南里,1786,778,187,263,66,73,339,3492,84,3576,4969,72.08250046
6601600-001,神岡區神岡里,994,608,141,152,30,41,193,2159,44,2203,3059,71.95499802
6601600-011,神岡區神洲里,943,366,112,127,26,27,171,1772,54,1826,2477,73.71500015
6601600-014,神岡區新庄里,1253,650,166,214,36,45,270,2634,92,2726,3926,69.57666779
6601600-012,神岡區溪洲里,961,459,134,117,19,24,214,1928,73,2001,2621,76.44500351
6601600-010,神岡區豐洲里,2309,1123,304,390,75,97,504,4802,119,4921,6858,71.7133344
6601400-002,梧棲區下寮里,574,345,73,92,24,28,118,1254,34,1288,1877,68.64500046
6601400-010,梧棲區大庄里,1905,1143,333,341,59,102,416,4299,94,4393,6698,65.31800156
6601400-011,梧棲區大村里,1445,918,263,284,75,74,325,3384,71,3455,5194,66.52750015
6601400-003,梧棲區中正里,1029,682,155,136,59,65,186,2312,44,2356,3772,62.83000056
6601400-004,梧棲區中和里,164,83,19,20,5,18,27,336,14,350,503,69.58000183
6601400-005,梧棲區文化里,335,205,65,64,17,22,81,789,18,807,1177,68.55999756
6601400-014,梧棲區永安里,745,466,108,114,20,32,162,1647,48,1695,2446,69.43500137
6601400-013,梧棲區永寧里,662,381,70,81,27,34,154,1409,41,1450,2210,65.54000092
6601400-006,梧棲區安仁里,233,142,39,34,12,15,40,515,11,526,800,65.75
6601400-008,梧棲區南簡里,1380,702,138,228,52,56,274,2830,81,2911,4320,67.46999868
6601400-007,梧棲區草湳里,1597,1037,293,267,66,99,384,3743,134,3877,5850,66.14249992
6601400-001,梧棲區頂寮里,803,506,134,120,55,69,176,1863,36,1899,2914,65.16499901
6601400-009,梧棲區福德里,1160,656,180,168,46,51,223,2484,59,2543,3915,64.94666672
6601400-012,梧棲區興農里,646,389,85,100,20,37,137,1414,46,1460,2193,66.53499985
6601200-028,清水區下湳里,923,505,116,116,45,27,201,1933,70,2003,2792,70.44999949
6601200-017,清水區中社里,375,723,133,92,30,147,157,1657,45,1702,2566,66.23666636
6601200-008,清水區中興里,138,79,30,23,6,2,26,304,11,315,418,75.36000061
6601200-004,清水區文昌里,219,124,19,42,11,16,37,468,10,478,655,72.98000336
6601200-007,清水區北寧里,245,156,22,30,9,7,57,526,13,539,692,77.88999939
6601200-026,清水區田寮里,793,311,95,96,25,17,126,1463,58,1521,2339,64.81999779
6601200-009,清水區西社里,730,354,112,118,17,34,134,1499,39,1538,2139,71.08000183
6601200-006,清水區西寧里,532,254,65,57,16,22,100,1046,32,1078,1521,70.87000275
6601200-032,清水區吳厝里,443,314,59,63,13,18,106,1016,52,1068,1388,76.94999695
6601200-013,清水區秀水里,1247,735,221,160,50,74,249,2736,99,2835,3979,71.23333232
6601200-029,清水區東山里,325,265,51,35,6,8,83,773,43,816,1158,70.47000122
6601200-014,清水區武鹿里,1021,566,131,150,43,35,176,2122,61,2183,3228,67.1299998
6601200-010,清水區南社里,2426,1472,386,400,100,193,465,5442,163,5605,8298,67.52333132
6601200-005,清水區南寧里,495,358,79,67,34,35,95,1163,23,1186,1707,69.45499802
6601200-031,清水區海風里,424,199,63,49,7,17,88,847,81,928,1298,71.48999786
6601200-015,清水區海濱里,638,351,75,88,10,18,113,1293,53,1346,1913,70.32999802
6601200-021,清水區高北里,266,225,48,36,7,10,63,655,36,691,1129,61.20000076
6601200-018,清水區高西里,297,272,43,30,8,7,82,739,53,792,1275,62.11999893
6601200-020,清水區高東里,422,144,54,41,14,10,91,776,50,826,1242,66.51000214
6601200-019,清水區高南里,410,240,80,53,14,17,81,895,42,937,1373,68.23999786
6601200-022,清水區高美里,348,287,59,36,14,14,67,825,34,859,1307,65.72000122
6601200-023,清水區國姓里,710,276,92,74,20,11,119,1302,63,1365,2065,66.49000168
6601200-003,清水區清水里,579,347,90,109,32,23,143,1323,28,1351,1942,69.49000168
6601200-025,清水區頂湳里,566,295,55,74,13,20,113,1136,66,1202,1730,69.5
6601200-024,清水區菁埔里,665,382,101,116,25,32,168,1489,64,1553,2224,69.94500351
6601200-030,清水區楊厝里,372,158,87,41,14,2,57,731,42,773,1125,68.70999908
6601200-011,清水區裕嘉里,461,219,84,63,23,21,68,939,47,986,1443,68.33000183
6601200-016,清水區槺榔里,1412,661,163,165,64,53,261,2779,88,2867,4346,65.97999827
6601200-027,清水區橋頭里,2296,1087,293,288,94,86,360,4504,148,4652,6902,67.43600006
6601200-012,清水區臨江里,466,375,77,54,21,19,107,1119,81,1200,1542,77.81999969
6601200-001,清水區鰲峰里,321,201,56,38,16,24,59,715,19,734,1074,68.33999634
6601200-002,清水區靈泉里,303,210,39,50,17,16,56,691,25,716,989,72.40000153
6601900-006,新社區大南里,471,418,100,64,21,26,156,1256,38,1294,1847,70.19000244
6601900-003,新社區中正里,407,243,52,56,10,45,117,930,28,958,1319,72.62999725
6601900-012,新社區中和里,99,183,48,10,12,17,37,406,19,425,593,71.66999817
6601900-008,新社區中興里,94,219,32,13,5,40,30,433,18,451,600,75.16999817
6601900-004,新社區月湖里,319,160,31,48,8,20,87,673,29,702,964,72.81999969
6601900-007,新社區永源里,960,471,136,145,30,42,225,2009,83,2092,2843,73.68333435
6601900-009,新社區協成里,879,467,125,85,37,47,177,1817,65,1882,2737,68.70999908
6601900-010,新社區東興里,297,258,75,41,12,15,99,797,25,822,1212,67.81999969
6601900-005,新社區崑山里,470,165,41,41,7,11,81,816,26,842,1128,74.65000153
6601900-002,新社區復盛里,457,358,80,50,11,28,128,1112,43,1155,1821,63.4450016
6601900-001,新社區新社里,859,674,129,151,46,61,235,2155,49,2204,3083,71.53499985
6601900-013,新社區福興里,335,245,60,25,7,22,83,777,20,797,1172,69.375
6601900-011,新社區慶西里,308,151,44,27,2,10,61,603,28,631,891,72.17499924
6601700-008,潭子區大富里,889,387,103,174,21,34,145,1753,42,1795,2440,73.56999969
6601700-009,潭子區大豐里,1757,947,254,314,60,89,339,3760,92,3852,5278,73.16333262
6601700-006,潭子區甘蔗里,2367,1689,537,495,125,202,576,5991,108,6099,8565,71.33799896
6601700-007,潭子區東寶里,3579,2039,565,625,154,254,774,7990,177,8167,11235,72.83857073
6601700-016,潭子區家福里,1180,802,192,222,61,116,262,2835,55,2890,4055,71.29000092
6601700-015,潭子區家興里,1570,1085,409,335,76,194,401,4070,78,4148,6251,66.22000122
6601700-010,潭子區栗林里,1516,838,182,240,54,57,287,3174,76,3250,4354,74.86999766
6601700-012,潭子區新田里,521,261,70,67,16,25,111,1071,34,1105,1476,74.86000061
6601700-011,潭子區嘉仁里,1154,708,157,177,50,58,219,2523,53,2576,3564,72.32500076
6601700-004,潭子區福仁里,2592,1761,543,457,116,244,574,6287,132,6419,9311,69.01199951
6601700-013,潭子區聚興里,1146,625,187,188,38,93,274,2551,73,2624,3653,71.88000107
6601700-003,潭子區潭北里,630,503,130,110,31,40,125,1569,28,1597,2213,72.10000229
6601700-002,潭子區潭秀里,446,215,51,95,30,15,116,968,34,1002,1301,77.01999664
6601700-001,潭子區潭陽里,3196,1953,531,539,121,203,612,7155,118,7273,10680,67.89000048
6601700-005,潭子區頭家里,1380,906,266,227,55,129,265,3228,56,3284,4646,70.94666545
6601700-014,潭子區頭家東里,1045,785,228,235,69,109,260,2731,65,2796,4027,69.38000107
6602500-008,龍井區三德里,857,485,109,137,31,31,223,1873,98,1971,2821,69.88499832
6602500-010,龍井區山腳里,1561,893,329,264,50,68,307,3472,117,3589,5257,68.37333425
6602500-004,龍井區田中里,1091,557,146,137,43,51,200,2225,83,2308,3198,72.02999878
6602500-001,龍井區竹坑里,817,532,148,159,29,39,187,1911,101,2012,2844,70.85499954
6602500-009,龍井區忠和里,1592,746,225,240,51,40,312,3206,137,3343,4543,73.66333262
6602500-016,龍井區東海里,1656,1500,454,393,201,282,570,5056,81,5137,7493,68.55200043
6602500-014,龍井區南寮里,507,288,57,60,19,22,82,1035,68,1103,1494,73.83000183
6602500-013,龍井區新庄里,1656,1022,288,273,81,107,421,3848,134,3982,5834,68.27000046
6602500-015,龍井區新東里,1163,862,233,229,86,91,315,2979,71,3050,4474,68.1875
6602500-005,龍井區福田里,236,224,33,43,15,17,92,660,39,699,994,70.31999969
6602500-003,龍井區龍西里,471,408,59,62,14,41,133,1188,45,1233,1769,69.69999695
6602500-002,龍井區龍東里,760,554,134,120,19,39,187,1813,56,1869,2659,70.25499725
6602500-011,龍井區龍泉里,1772,1228,322,323,102,101,495,4343,133,4476,6628,67.82600098
6602500-007,龍井區龍津里,1475,844,183,235,57,55,390,3239,97,3336,4717,70.94000053
6602500-012,龍井區龍崗里,657,449,121,132,29,27,208,1623,65,1688,2461,69.64500046
6602500-006,龍井區麗水里,580,429,138,90,23,24,150,1434,66,1500,2144,69.75500107
6600900-020,豐原區三村里,1850,1002,279,324,103,122,419,4099,66,4165,5902,70.72000122
6600900-005,豐原區下街里,234,123,41,36,18,34,48,534,5,539,760,70.91999817
6600900-013,豐原區大湳里,754,417,140,128,27,56,169,1691,26,1717,2431,70.56999969
6600900-003,豐原區中山里,290,166,41,36,18,23,45,619,8,627,823,76.18000031
6600900-028,豐原區中陽里,1572,997,219,271,86,115,351,3611,66,3677,4936,74.44666799
6600900-021,豐原區中興里,704,615,135,126,63,90,192,1925,35,1960,2763,70.76000214
6600900-014,豐原區北湳里,835,573,141,142,35,59,183,1968,44,2012,2844,70.74500275
6600900-027,豐原區北陽里,3757,2307,556,633,207,265,834,8559,164,8723,12129,71.91285706
6600900-012,豐原區民生里,370,202,57,69,20,19,72,809,7,816,1118,72.98999786
6600900-022,豐原區田心里,1732,1017,240,262,103,173,356,3883,60,3943,5994,66.53000005
6600900-017,豐原區圳寮里,415,217,51,80,26,24,80,893,15,908,1189,76.37000275
6600900-036,豐原區朴子里,1225,447,150,166,44,28,241,2301,46,2347,3201,73.30000051
6600900-009,豐原區西安里,1539,927,241,303,93,125,333,3561,68,3629,4922,73.8799998
6600900-016,豐原區西湳里,2777,1345,340,473,116,133,532,5716,120,5836,8108,71.97599792
6600900-010,豐原區西勢里,631,413,88,100,34,65,142,1473,21,1494,2040,72.98500061
6600900-015,豐原區東湳里,1450,662,171,213,38,44,272,2850,59,2909,3986,73.10333252
6600900-029,豐原區東陽里,617,245,75,77,18,11,80,1123,28,1151,1555,74.01999664
6600900-011,豐原區東勢里,477,231,65,76,41,43,101,1034,20,1054,1443,73.04000092
6600900-019,豐原區社皮里,2672,1576,467,493,169,207,612,6196,107,6303,9238,68.15999908
6600900-031,豐原區南田里,1076,537,130,165,59,50,197,2214,55,2269,3108,73.30500031
6600900-030,豐原區南村里,1680,791,247,270,81,85,332,3486,54,3540,4950,71.44666545
6600900-025,豐原區南陽里,2844,1845,447,504,176,200,562,6578,112,6690,9420,71.08999939
6600900-032,豐原區南嵩里,1123,478,129,181,61,48,224,2244,53,2297,3118,73.59000015
6600900-034,豐原區翁子里,903,486,134,117,33,40,218,1931,43,1974,2753,71.72499847
6600900-033,豐原區翁明里,642,397,87,118,31,35,141,1451,19,1470,2012,73.05999756
6600900-035,豐原區翁社里,682,403,75,90,34,30,153,1467,49,1516,2018,74.65499878
6600900-002,豐原區頂街里,308,136,35,44,20,19,65,627,11,638,901,70.80999756
6600900-006,豐原區富春里,259,173,32,36,24,17,63,604,10,614,764,80.37000275
6600900-026,豐原區陽明里,772,532,114,136,45,63,163,1825,22,1847,2591,71.41999817
6600900-007,豐原區葫蘆里,223,125,36,31,20,8,43,486,9,495,643,76.98000336
6600900-023,豐原區豐田里,3120,1694,406,500,129,189,636,6674,144,6818,9552,71.35600128
6600900-018,豐原區豐圳里,864,643,197,159,64,73,233,2233,43,2276,3169,71.80500031
6600900-008,豐原區豐西里,494,346,77,93,24,43,78,1155,13,1168,1607,72.68000031
6600900-001,豐原區豐原里,558,477,104,102,35,54,104,1434,34,1468,2154,67.73500061
6600900-004,豐原區豐榮里,374,178,52,61,16,18,80,779,12,791,1090,72.56999969
6600900-024,豐原區鎌村里,1484,806,213,189,44,64,288,3088,75,3163,4441,71.22333527
6602600-018,霧峰區丁台里,835,295,112,85,15,20,170,1532,62,1594,2136,74.61000061
6602600-005,霧峰區中正里,521,378,122,94,38,45,122,1320,37,1357,1893,71.54999924
6602600-013,霧峰區五福里,802,460,184,111,42,36,182,1817,70,1887,2472,76.38000107
6602600-017,霧峰區六股里,829,357,132,82,31,25,149,1605,78,1683,2229,75.54999924
6602600-010,霧峰區北柳里,1192,649,211,191,44,69,232,2588,74,2662,3634,73.24333445
6602600-019,霧峰區北勢里,558,412,135,88,23,40,134,1390,60,1450,1962,73.78499985
6602600-012,霧峰區四德里,719,354,134,90,39,45,137,1518,52,1570,2227,70.49499893
6602600-008,霧峰區本堂里,1386,1096,389,281,93,187,380,3812,86,3898,5517,70.6475029
6602600-004,霧峰區本鄉里,676,453,118,108,29,48,128,1560,27,1587,2184,73.12000275
6602600-003,霧峰區甲寅里,1262,855,298,213,64,83,287,3062,78,3140,4470,70.32333374
6602600-002,霧峰區吉峰里,2374,1522,547,360,128,181,523,5635,127,5762,8676,66.48166656
6602600-009,霧峰區坑口里,728,551,214,109,43,69,181,1895,44,1939,2783,69.78499985
6602600-011,霧峰區南柳里,589,361,102,83,29,21,119,1304,37,1341,1747,76.81999969
6602600-020,霧峰區南勢里,387,181,97,43,9,21,94,832,35,867,1232,70.37000275
6602600-016,霧峰區峰谷里,341,184,69,37,13,13,79,736,40,776,1087,71.38999939
6602600-001,霧峰區桐林里,378,236,96,42,19,20,72,863,26,889,1156,76.90000153
6602600-007,霧峰區萊園里,307,171,66,37,7,15,76,679,27,706,1041,67.81999969
6602600-014,霧峰區萬豐里,821,411,133,110,47,51,175,1748,44,1792,2562,69.94000244
6602600-006,霧峰區錦榮里,324,235,65,41,16,35,73,789,21,810,1137,71.23999786
6602600-015,霧峰區舊正里,620,316,146,75,39,50,153,1399,55,1454,1988,73.13999939
6701500-010,七股區七股里,433,55,19,41,12,1,45,606,11,617,897,68.77999878
6701500-023,七股區十份里,448,124,20,37,11,13,75,728,34,762,1347,56.56999969
6701500-022,七股區三股里,496,119,28,53,5,7,75,783,29,812,1386,58.59000015
6701500-012,七股區大埕里,610,116,43,50,18,14,88,939,15,954,1605,59.43999863
6701500-013,七股區大寮里,399,77,30,21,12,12,38,589,22,611,934,65.41999817
6701500-002,七股區大潭里,249,72,21,13,9,3,33,400,13,413,670,61.63999939
6701500-017,七股區中寮里,251,83,18,21,3,7,35,418,12,430,733,58.65999985
6701500-021,七股區永吉里,358,80,21,28,6,6,60,559,25,584,956,61.09000015
6701500-011,七股區玉成里,301,85,19,17,7,4,39,472,13,485,759,63.90000153
6701500-016,七股區竹港里,269,65,21,26,8,2,33,424,7,431,624,69.06999969
6701500-018,七股區竹橋里,281,53,26,11,4,8,29,412,11,423,646,65.48000336
6701500-006,七股區西寮里,168,38,8,12,1,3,41,271,7,278,476,58.40000153
6701500-003,七股區城內里,239,41,7,9,5,4,19,324,13,337,472,71.40000153
6701500-001,七股區後港里,229,53,20,8,8,4,45,367,11,378,560,67.5
6701500-014,七股區看坪里,314,41,12,24,2,5,31,429,8,437,687,63.61000061
6701500-005,七股區頂山里,343,81,26,13,5,1,22,491,10,501,836,59.93000031
6701500-007,七股區塩埕里,113,51,5,23,0,4,33,229,2,231,397,58.18999863
6701500-009,七股區溪南里,115,58,16,13,5,3,15,225,11,236,351,67.23999786
6701500-019,七股區義合里,416,116,31,30,8,10,75,686,9,695,1088,63.88000107
6701500-020,七股區槺榔里,251,56,47,22,11,3,45,435,12,447,694,64.41000366
6701500-015,七股區樹林里,472,92,28,44,8,8,53,705,11,716,1122,63.81000137
6701500-004,七股區篤加里,325,71,16,18,8,7,39,484,6,490,795,61.63999939
6701500-008,七股區龍山里,708,125,39,60,5,5,83,1025,29,1054,1669,63.23500061
6700800-001,下營區下營里,273,107,25,21,8,12,45,491,8,499,838,59.54999924
6700800-007,下營區大屯里,290,69,65,18,9,6,53,510,9,519,834,62.22999954
6700800-008,下營區大埤里,275,79,21,20,6,4,41,446,15,461,714,64.56999969
6700800-010,下營區中營里,454,100,31,29,12,5,56,687,21,708,1076,65.80000305
6700800-002,下營區仁里里,903,340,73,109,25,28,156,1634,46,1680,2847,58.93999863
6700800-014,下營區甲中里,463,92,27,28,6,5,60,681,34,715,1100,65
6700800-003,下營區宅內里,301,175,34,37,11,5,63,626,26,652,1061,61.45000076
6700800-012,下營區西連里,426,64,26,22,12,4,47,601,16,617,887,69.55999756
6700800-004,下營區後街里,473,227,69,47,13,16,91,936,11,947,1532,61.81000137
6700800-015,下營區紅厝里,425,72,106,44,12,11,68,738,38,776,1178,65.87000275
6700800-009,下營區茅港里,501,118,31,44,10,7,72,783,12,795,1177,67.54000092
6700800-013,下營區賀建里,474,95,24,29,11,20,82,735,32,767,1298,59.09000015
6700800-011,下營區開化里,828,215,41,59,19,8,101,1271,29,1300,1919,67.47999954
6700800-005,下營區新興里,783,274,88,71,19,18,116,1369,33,1402,2299,60.97499847
6700800-006,下營區營前里,734,265,50,80,24,26,113,1292,45,1337,2068,64.63999939
6701100-009,大內區二溪里,333,111,39,12,6,5,38,544,13,557,843,66.06999969
6701100-005,大內區大內里,301,112,28,27,10,5,51,534,7,541,798,67.79000092
6701100-004,大內區內江里,346,128,41,28,9,5,38,595,9,604,936,64.52999878
6701100-006,大內區內郭里,240,63,20,17,3,0,38,381,10,391,615,63.58000183
6701100-002,大內區石林里,318,47,24,13,8,2,38,450,6,456,654,69.72000122
6701100-003,大內區石城里,621,145,46,32,23,11,54,932,21,953,1453,65.58999634
6701100-001,大內區石湖里,408,100,41,19,6,7,59,640,16,656,1014,63.35000038
6701100-010,大內區曲溪里,256,45,27,16,4,5,27,380,17,397,578,68.69000244
6701100-007,大內區頭社里,380,105,30,16,4,1,57,593,13,606,995,60.90000153
6701100-008,大內區環湖里,247,101,33,8,2,8,37,436,11,447,746,59.91999817
6702200-003,山上區山上里,297,116,28,35,9,8,44,537,20,557,898,62.02999878
6702200-006,山上區平陽里,107,78,15,10,5,3,9,227,9,236,378,62.43000031
6702200-005,山上區玉峯里,191,53,13,11,5,10,16,299,12,311,542,57.38000107
6702200-001,山上區明和里,661,176,55,47,15,9,72,1035,38,1073,1680,63.97000122
6702200-002,山上區南洲里,600,181,68,60,28,11,60,1008,29,1037,1556,66.65999985
6702200-004,山上區新莊里,368,90,48,38,11,5,41,601,16,617,906,68.09999847
6702200-007,山上區豐德里,168,27,11,11,4,0,14,235,7,242,381,63.52000046
6703700-018,中西區三民里,399,178,42,63,17,21,89,809,13,822,1239,66.33999634
6703700-035,中西區三合里,604,221,54,60,34,30,96,1099,17,1116,1759,63.45000076
6703700-010,中西區大南里,304,278,55,53,27,43,89,849,5,854,1200,71.16999817
6703700-031,中西區大涼里,909,393,128,134,49,63,153,1829,23,1852,2766,66.95999908
6703700-003,中西區小西里,235,105,23,36,15,17,35,466,2,468,665,70.37999725
6703700-030,中西區中正里,405,131,40,51,22,20,62,731,10,741,1081,68.55000305
6703700-006,中西區五妃里,448,249,52,80,48,49,104,1030,5,1035,1516,68.26999664
6703700-026,中西區元安里,445,165,41,47,21,25,77,821,13,834,1211,68.87000275
6703700-001,中西區公正里,464,174,30,65,37,25,91,886,5,891,1387,64.23999786
6703700-017,中西區天后里,445,202,43,57,35,17,73,872,13,885,1308,67.66000366
6703700-024,中西區文賢里,512,154,42,60,23,11,70,872,14,886,1288,68.79000092
6703700-021,中西區水仙里,418,145,45,50,18,10,65,751,13,764,1135,67.30999756
6703700-004,中西區仙草里,697,339,103,92,69,53,144,1497,17,1514,2382,63.57500076
6703700-032,中西區民主里,332,105,36,54,18,20,62,627,8,635,931,68.20999908
6703700-029,中西區民生里,692,231,46,61,17,21,95,1163,19,1182,1755,67.34999847
6703700-036,中西區民權里,562,154,45,68,22,24,81,956,13,969,1434,67.56999969
6703700-016,中西區永華里,417,174,37,49,26,22,84,809,9,818,1202,68.05000305
6703700-015,中西區永福里,415,146,35,52,20,8,68,744,6,750,1139,65.84999847
6703700-025,中西區光賢里,1337,421,145,177,70,55,191,2396,31,2427,3412,71.18500137
6703700-028,中西區安海里,417,202,55,61,38,31,69,873,9,882,1422,62.02999878
6703700-033,中西區西湖里,1561,757,183,278,113,92,281,3265,28,3293,4819,68.36333466
6703700-034,中西區西賢里,1522,661,197,264,115,110,268,3137,35,3172,4610,68.80333201
6703700-005,中西區赤嵌里,446,162,42,59,31,28,78,846,11,857,1322,64.83000183
6703700-023,中西區協和里,737,220,74,71,37,27,95,1261,11,1272,2118,60.80500031
6703700-027,中西區協進里,358,140,45,35,20,24,54,676,11,687,996,68.98000336
6703700-009,中西區法華里,686,402,83,131,65,82,175,1624,17,1641,2460,66.50999832
6703700-014,中西區青年里,422,169,26,52,25,27,68,789,6,795,1190,66.80999756
6703700-037,中西區保安里,389,123,35,40,33,17,57,694,19,713,1063,67.06999969
6703700-013,中西區建國里,380,166,40,49,20,12,47,714,6,720,1127,63.88999939
6703700-007,中西區郡王里,411,201,50,83,45,40,85,915,11,926,1358,68.19000244
6703700-038,中西區郡西里,373,149,25,43,21,11,62,684,23,707,1052,67.20999908
6703700-020,中西區普濟里,326,152,22,41,18,17,35,611,7,618,1019,60.65000153
6703700-012,中西區進學里,343,185,42,52,42,23,93,780,12,792,1142,69.34999847
6703700-011,中西區開山里,597,207,60,69,39,26,147,1145,14,1159,1814,63.88500023
6703700-019,中西區萬昌里,668,207,48,59,26,20,107,1135,11,1146,1749,65.51999664
6703700-008,中西區福安里,331,154,25,46,21,22,60,659,10,669,955,70.05000305
6703700-002,中西區銀同里,353,172,43,43,27,27,59,724,6,730,1101,66.30000305
6703700-022,中西區藥王里,1117,420,116,133,64,50,188,2088,23,2111,3170,66.95999908
6702700-003,仁德區一甲里,955,341,77,139,38,28,146,1724,30,1754,2562,68.52000046
6702700-015,仁德區二行里,740,256,75,86,47,25,115,1344,38,1382,2010,68.84000015
6702700-010,仁德區三甲里,320,112,47,35,8,11,50,583,12,595,808,73.63999939
6702700-008,仁德區上崙里,2018,572,179,208,68,54,234,3333,69,3402,5043,67.58499908
6702700-002,仁德區土庫里,1158,248,49,108,29,35,130,1757,33,1790,2491,71.97000122
6702700-016,仁德區大甲里,844,267,73,81,39,19,95,1418,51,1469,2081,70.84000015
6702700-018,仁德區中生里,543,172,28,56,16,13,54,882,19,901,1359,66.30000305
6702700-017,仁德區中洲里,550,124,26,50,14,22,54,840,27,867,1283,67.58000183
6702700-013,仁德區仁和里,61,424,62,18,19,127,62,773,17,790,1184,66.72000122
6702700-014,仁德區仁愛里,318,281,74,42,7,51,75,848,13,861,1359,63.36000061
6702700-005,仁德區仁義里,3182,1247,247,390,153,122,437,5778,85,5863,8685,67.50428554
6702700-004,仁德區仁德里,2267,887,232,319,114,133,388,4340,68,4408,6694,65.14599991
6702700-001,仁德區太子里,2190,582,143,220,98,64,268,3565,70,3635,5145,70.68499947
6702700-009,仁德區田厝里,517,176,25,57,11,14,89,889,25,914,1354,67.5
6702700-012,仁德區成功里,1286,879,188,158,66,153,258,2988,52,3040,4540,66.88749886
6702700-011,仁德區保安里,1011,320,87,103,36,39,137,1733,31,1764,2622,67.14499664
6702700-007,仁德區後壁里,3244,968,296,381,145,111,456,5601,115,5716,8487,67.83333333
6702700-006,仁德區新田里,1205,388,115,127,41,47,156,2079,29,2108,3069,68.83000183
6700900-005,六甲區七甲里,401,70,19,28,7,8,53,586,25,611,897,68.12000275
6700900-006,六甲區二甲里,1177,318,97,129,45,36,186,1988,49,2037,3158,64.49999873
6700900-012,六甲區大丘里,201,54,23,11,1,8,28,326,11,337,643,52.40999985
6700900-008,六甲區中社里,586,178,42,63,21,25,99,1014,13,1027,1583,65.00000191
6700900-001,六甲區六甲里,1016,326,69,108,40,23,195,1777,51,1828,2831,64.79000092
6700900-007,六甲區水林里,835,214,78,80,26,18,130,1381,40,1421,2105,67.40999985
6700900-011,六甲區王爺里,263,63,22,12,3,4,42,409,13,422,752,56.11999893
6700900-002,六甲區甲東里,960,257,71,78,37,22,159,1584,43,1627,2574,63.06499863
6700900-003,六甲區甲南里,493,144,44,48,14,19,81,843,12,855,1342,63.70999908
6700900-010,六甲區菁埔里,225,63,30,13,4,4,42,381,12,393,604,65.06999969
6700900-004,六甲區龍湖里,391,91,36,31,8,6,59,622,9,631,1020,61.86000061
6700900-009,六甲區龜港里,411,142,41,36,15,4,75,724,15,739,1096,67.43000031
6701700-007,北門區三光里,463,94,29,31,18,7,78,720,7,727,1174,62.22999954
6701700-010,北門區中樞里,257,37,13,20,6,8,47,388,8,396,673,58.84000015
6701700-008,北門區仁里里,237,62,10,23,8,6,21,367,13,380,632,60.13000107
6701700-005,北門區北門里,269,113,22,19,7,12,69,511,20,531,856,61.26000214
6701700-012,北門區永華里,128,33,7,5,3,1,10,187,9,196,368,53.25999832
6701700-013,北門區永隆里,90,94,10,6,0,10,33,243,5,248,509,48.72000122
6701700-009,北門區玉港里,310,65,21,17,4,16,32,465,11,476,749,64.18500137
6701700-003,北門區東壁里,243,61,36,16,8,5,34,403,10,413,762,54.20000076
6701700-001,北門區保吉里,431,159,39,36,8,14,65,752,17,769,1350,56.91499901
6701700-011,北門區慈安里,237,59,26,15,9,14,29,389,17,406,723,56.15000153
6701700-006,北門區錦湖里,349,75,16,10,5,2,42,499,12,511,975,52.40999985
6701700-002,北門區雙春里,141,63,6,15,5,1,33,264,7,271,485,55.88000107
6701700-004,北門區鯤江里,288,53,20,14,9,12,44,440,9,449,759,59.73500061
6703400-005,北區力行里,699,389,83,122,61,74,133,1561,24,1585,2327,67.9849968
6703400-036,北區三德里,386,171,35,54,22,16,73,757,16,773,1147,67.38999939
6700700-018,北區大仁里、大山里,404,240,61,49,20,33,75,882,13,895,1435,62.36999893
6703400-042,北區大和里,1421,399,124,181,81,48,186,2440,33,2473,3515,70.35499954
6703400-026,北區大港里,1837,718,175,244,85,84,267,3410,38,3448,5144,66.98999786
6703400-011,北區大道里,227,677,125,64,26,152,107,1378,26,1404,2155,65.19000244
6703400-018,北區大豐里,1607,498,160,221,77,51,231,2845,34,2879,4316,66.87666575
6703400-014,北區小康里,708,277,96,90,40,46,117,1374,26,1400,2082,67.27000046
6703400-032,北區中樓里,460,229,61,70,29,19,92,960,12,972,1480,65.68000031
6703400-037,北區五福里,369,137,36,53,15,20,61,691,12,703,1533,45.86000061
6703400-008,北區仁愛里,540,316,67,95,45,49,126,1238,14,1252,1811,69.14500046
6703400-038,北區元寶里,778,382,136,161,74,67,183,1781,15,1796,2882,62.51000023
6703400-033,北區公園里,494,288,74,66,29,48,102,1101,17,1118,1759,62.82999992
6703400-022,北區六甲里,787,329,100,93,46,49,136,1540,21,1561,2423,64.42499924
6703400-025,北區文元里,2128,746,208,340,120,106,278,3926,50,3976,5836,68.11000061
6703400-041,北區文成里,1227,450,123,167,53,46,185,2251,22,2273,3269,69.53499985
6703400-015,北區正風里,560,168,49,61,18,25,81,962,13,975,1399,69.69000244
6703400-023,北區正覺里,1283,415,97,146,46,36,191,2214,30,2244,3237,69.28666433
6703400-039,北區永祥里,931,489,133,113,51,77,147,1941,36,1977,2846,69.44000244
6703400-034,北區玉皇里,533,198,50,65,28,24,78,976,5,981,1495,65.62000275
6703400-012,北區光武里,277,340,66,41,23,65,68,880,19,899,1387,64.81999969
6703400-029,北區安民里,475,161,33,62,16,12,69,828,6,834,1198,69.62000275
6703400-024,北區成功里,1470,539,134,252,97,77,221,2790,24,2814,4097,68.55999756
6703400-040,北區成德里,3448,1396,400,649,266,212,608,6979,82,7061,10567,66.85833232
6703400-020,北區和順里,2043,847,236,372,181,152,367,4198,37,4235,6382,66.39500046
6703400-016,北區延平里,614,201,68,45,30,31,101,1090,18,1108,1625,68.18000031
6703400-004,北區東興里,537,431,87,83,45,68,121,1372,20,1392,2035,68.41500092
6703400-031,北區長榮里,267,851,158,83,46,154,163,1722,29,1751,2611,66.38999939
6703400-035,北區長德里,448,175,35,53,20,19,78,828,12,840,1251,67.15000153
6703400-019,北區重興里,604,371,100,107,58,63,134,1437,16,1453,2103,69.07999802
6703400-007,北區振興里,566,263,54,71,33,44,100,1131,19,1150,1745,65.90499878
6703400-021,北區國姓里,569,189,57,66,15,17,78,991,11,1002,1447,69.25
6703400-027,北區國興里,503,223,46,80,35,39,88,1014,19,1033,1538,67.16999817
6703400-003,北區勝安里,331,193,43,59,23,18,52,719,11,730,1098,66.48000336
6703400-006,北區華興里,736,322,100,91,49,40,122,1460,19,1479,2103,70.35499954
6703400-001,北區開元里,761,337,95,94,34,46,110,1477,22,1499,2190,68.38999939
6703400-002,北區新勝里,521,284,59,75,21,35,81,1076,17,1093,1691,64.63499832
6703400-028,北區裕民里,531,197,37,61,24,30,88,968,10,978,1393,70.20999908
6703400-013,北區實踐里,488,391,103,81,29,80,114,1286,20,1306,1948,67.04000092
6703400-043,北區賢北里,1231,470,161,218,64,73,180,2397,24,2421,3415,70.91500092
6703400-017,北區興北里,510,180,55,61,26,32,63,927,9,936,1335,70.11000061
6703400-030,北區興南里,510,183,68,74,32,26,92,985,17,1002,1534,65.31999969
6702600-010,左鎮區二寮里,79,15,26,5,1,1,8,135,6,141,202,69.80000305
6702600-004,左鎮區中正里,232,94,60,22,4,12,32,456,18,474,777,61
6702600-006,左鎮區內庄里,108,83,26,11,2,8,15,253,11,264,413,63.91999817
6702600-003,左鎮區左鎮里,155,50,23,8,2,2,28,268,8,276,470,58.72000122
6702600-001,左鎮區光和里,118,54,17,2,2,5,22,220,10,230,396,58.08000183
6702600-008,左鎮區岡林里,156,41,21,1,4,2,31,256,6,262,435,60.22999954
6702600-009,左鎮區草山里,100,19,6,4,3,14,12,158,13,171,319,53.61000061
6702600-005,左鎮區睦光里,119,37,41,7,6,6,19,235,7,242,366,66.12000275
6702600-002,左鎮區榮和里,248,67,20,14,8,6,29,392,14,406,648,62.65000153
6702600-007,左鎮區澄山里,196,38,14,9,5,3,37,302,12,314,515,60.97000122
6703100-030,永康區二王里,2282,1081,292,294,137,168,444,4698,68,4766,7371,64.65600128
6703100-009,永康區三民里,523,182,50,48,26,19,110,958,23,981,1370,71.17499924
6703100-032,永康區三合里,1088,469,122,135,57,56,167,2094,29,2123,3301,64.39666621
6703100-005,永康區大橋里,1751,764,212,260,101,94,273,3455,33,3488,5411,64.53750038
6703100-012,永康區大灣里,1375,359,119,116,45,36,210,2260,36,2296,3337,68.76666768
6703100-039,永康區中華里,781,458,107,103,80,137,149,1815,24,1839,2671,69.56999969
6703100-025,永康區中興里,909,609,151,146,67,107,194,2183,25,2208,3301,66.88999939
6703100-001,永康區五王里,1714,777,205,243,85,92,291,3407,44,3451,5437,63.51999855
6703100-031,永康區六合里,1553,735,239,251,95,122,338,3333,53,3386,5130,66.00500011
6703100-006,永康區王行里,990,227,87,100,36,20,131,1591,25,1616,2387,67.69000244
6703100-017,永康區北灣里,3081,934,264,352,141,100,479,5351,55,5406,8089,66.86499914
6703100-038,永康區正強里,2620,983,287,311,140,113,315,4769,66,4835,7226,66.92400055
6703100-003,永康區永康里,2636,856,272,325,103,134,356,4682,64,4746,8283,59.05166626
6703100-011,永康區甲頂里,891,298,71,108,41,30,130,1569,23,1592,2233,71.94999949
6703100-028,永康區光復里,89,122,28,8,3,24,29,303,11,314,523,60.04000092
6703100-034,永康區安康里,1403,553,191,232,85,63,216,2743,38,2781,4589,60.74000041
6703100-024,永康區成功里,339,626,107,54,29,80,106,1341,25,1366,2088,65.45000076
6703100-023,永康區西勢里,2294,707,253,293,102,69,316,4034,56,4090,6103,67.02000046
6703100-035,永康區西橋里,1005,378,108,161,61,64,182,1959,23,1982,3052,64.98500061
6703100-014,永康區西灣里,2591,829,238,367,138,124,406,4693,50,4743,6891,68.92400055
6703100-036,永康區尚頂里,1395,429,134,186,50,57,202,2453,25,2478,3665,67.87333425
6703100-033,永康區東橋里,1447,564,156,240,104,79,222,2812,22,2834,4180,67.79999924
6703100-013,永康區東灣里,1425,415,126,154,49,40,198,2407,31,2438,3586,68.1299998
6703100-015,永康區南灣里,1573,363,119,143,43,57,230,2528,25,2553,3722,68.73333486
6703100-021,永康區建國里,287,467,95,51,14,54,102,1070,17,1087,1678,64.77499962
6703100-004,永康區埔園里,3654,1001,391,438,148,114,491,6237,64,6301,9446,66.68666585
6703100-007,永康區烏竹里,938,298,103,138,43,26,148,1694,28,1722,2485,69.30500031
6703100-022,永康區神洲里,251,240,59,30,9,35,54,678,14,692,1137,60.86000061
6703100-016,永康區崑山里,2166,742,165,277,108,99,365,3922,53,3975,5772,68.80800018
6703100-026,永康區勝利里,1963,1236,301,326,137,159,414,4536,65,4601,7149,64.45400009
6703100-020,永康區復國里,1996,1300,363,324,139,254,456,4832,70,4902,7608,64.64666684
6703100-037,永康區復華里,2441,1333,438,373,169,220,452,5426,58,5484,8607,63.76142883
6703100-019,永康區復興里,310,542,77,39,17,44,100,1129,32,1161,1937,59.32999992
6703100-010,永康區塩行里,3004,889,289,378,151,114,368,5193,70,5263,8118,64.81999969
6703100-029,永康區塩洲里,2098,640,187,278,85,87,276,3651,61,3712,5481,67.67749977
6703100-018,永康區新樹里,675,127,52,45,23,6,94,1022,17,1039,1439,71.95499802
6703100-002,永康區網寮里,2119,756,250,251,104,116,339,3935,58,3993,6122,65.25749969
6703100-008,永康區蔦松里,672,204,61,65,15,18,91,1126,8,1134,1715,66.13000107
6703100-027,永康區龍潭里,3483,1052,348,456,168,119,525,6151,80,6231,9703,64.38428606
6702300-007,玉井區三和里,232,117,42,19,2,9,30,451,8,459,738,62.20000076
6702300-006,玉井區三埔里,143,65,29,5,2,7,21,272,8,280,494,56.68000031
6702300-003,玉井區中正里,353,176,56,34,7,16,77,719,20,739,1221,60.51499939
6702300-001,玉井區玉井里,206,162,61,26,10,12,28,505,7,512,794,64.48000336
6702300-002,玉井區玉田里,1063,647,246,102,48,53,186,2345,46,2391,3971,60.21500015
6702300-004,玉井區竹圍里,419,205,63,38,18,14,86,843,19,862,1392,61.72999954
6702300-005,玉井區沙田里,114,105,14,15,2,4,32,286,12,298,506,58.88999939
6702300-008,玉井區望明里,458,207,64,23,13,11,80,856,35,891,1485,60.125
6702300-009,玉井區層林里,184,65,80,10,7,3,23,372,11,383,630,60.79000092
6702300-010,玉井區豐里里,256,126,69,15,7,19,52,544,28,572,991,57.72000122
6700300-014,白河區大竹里,517,160,27,34,11,13,78,840,22,862,1440,59.83500099
6700300-008,白河區大林里,258,38,10,8,4,7,23,348,14,362,612,59.15000153
6700300-022,白河區內角里,292,80,17,14,5,6,41,455,11,466,713,65.36000061
6700300-010,白河區六溪里,176,34,14,7,4,1,30,266,10,276,537,51.40000153
6700300-011,白河區仙草里,406,214,31,20,5,15,81,772,45,817,1396,57.83500099
6700300-003,白河區外角里,511,121,33,38,5,15,83,806,18,824,1359,60.63000107
6700300-002,白河區永安里,989,316,67,117,41,36,197,1763,20,1783,2833,62.9399999
6700300-013,白河區玉豐里,411,125,40,42,5,13,111,747,10,757,1201,63.02999878
6700300-024,白河區甘宅里,208,36,12,10,4,2,43,315,14,329,601,54.74000168
6700300-001,白河區白河里,565,204,49,57,26,26,103,1030,28,1058,1698,62.61000061
6700300-004,白河區庄內里,572,155,47,56,8,15,106,959,23,982,1584,61.94000053
6700300-018,白河區竹門里,298,109,25,26,7,6,53,524,22,546,880,62.04999924
6700300-021,白河區汴頭里,306,54,6,8,6,5,44,429,19,448,735,60.95000076
6700300-005,白河區秀祐里,306,80,28,27,7,13,52,513,12,525,885,59.31999969
6700300-020,白河區昇安里,528,122,42,35,11,15,80,833,18,851,1311,64.91000366
6700300-006,白河區河東里,495,130,26,38,15,16,69,789,25,814,1305,63.06999969
6700300-007,白河區虎山里,174,44,12,8,3,2,24,267,13,280,453,61.81000137
6700300-009,白河區崁頭里,129,26,10,7,5,3,33,213,6,219,378,57.93999863
6700300-023,白河區草店里,250,104,18,24,2,10,70,478,13,491,844,58.18000031
6700300-019,白河區崎內里,214,90,21,15,6,13,57,416,12,428,731,58.54999924
6700300-015,白河區詔安里,333,59,11,22,8,4,54,491,13,504,841,59.93000031
6700300-016,白河區廣安里,235,58,10,10,4,10,45,372,10,382,639,59.77999878
6700300-017,白河區蓮潭里,351,74,16,27,12,3,97,580,10,590,864,68.29000092
6700300-012,白河區關嶺里,356,110,41,20,9,10,53,599,17,616,1073,58.23500061
6703600-009,安平區文平里,1560,684,191,245,104,99,240,3123,43,3166,4557,69.39666748
6703600-015,安平區平安里,1145,445,110,163,69,46,192,2170,28,2198,3303,66.56000137
6703600-008,安平區平通里,2044,842,240,277,127,113,295,3938,58,3996,6701,59.44000053
6703600-003,安平區石門里,806,251,86,104,31,20,97,1395,19,1414,2114,66.88999939
6703600-001,安平區西門里,453,199,62,36,9,29,58,846,20,866,1307,66.26000214
6703600-011,安平區育平里,1984,875,278,302,133,178,348,4098,34,4132,6833,60.32500076
6703600-006,安平區怡平里,1158,451,141,202,84,75,210,2321,36,2357,3811,61.56500244
6703600-002,安平區金城里,526,311,102,72,33,71,92,1207,24,1231,1874,65.69000244
6703600-005,安平區建平里,1426,580,167,191,86,95,275,2820,20,2840,4415,64.32499695
6703600-013,安平區海頭里,538,174,57,60,32,15,75,951,17,968,1484,65.23000336
6703600-010,安平區國平里,1749,844,252,337,128,166,315,3791,64,3855,5977,64.47333399
6703600-014,安平區港仔里,528,149,38,62,17,11,56,861,13,874,1276,68.5
6703600-007,安平區華平里,1414,646,200,189,92,82,226,2849,22,2871,4527,63.43000031
6703600-004,安平區漁光里,175,52,23,14,7,2,15,288,18,306,449,68.15000153
6703600-012,安平區億載里,855,371,97,121,50,41,157,1692,17,1709,2548,67.01000214
6702100-010,安定區大同里,265,108,20,19,5,6,29,452,14,466,696,66.94999695
6702100-012,安定區中沙里,299,91,10,17,8,2,31,458,12,470,685,68.61000061
6702100-007,安定區中榮里,631,142,36,64,27,26,84,1010,28,1038,1542,67.31999969
6702100-011,安定區六嘉里,691,127,50,62,10,7,74,1021,38,1059,1488,71.16999817
6702100-004,安定區安加里,498,129,32,40,12,14,80,805,20,825,1241,66.48000336
6702100-003,安定區安定里,588,144,39,57,22,23,56,929,27,956,1424,67.12999725
6702100-005,安定區保西里,262,107,22,18,11,15,35,470,20,490,766,63.97000122
6702100-016,安定區南安里,224,82,20,22,8,6,32,394,12,406,593,68.47000122
6702100-014,安定區海寮里,947,282,84,88,26,19,115,1561,26,1587,2448,64.81999969
6702100-008,安定區港口里,1011,340,88,105,41,35,151,1771,43,1814,2660,67.96999741
6702100-006,安定區港尾里,622,156,51,50,27,10,73,989,31,1020,1505,67.77500153
6702100-009,安定區港南里,939,277,79,89,17,30,116,1547,49,1596,2447,65.38000107
6702100-013,安定區新吉里,1009,233,70,105,26,15,123,1581,37,1618,2360,68.5399971
6702100-015,安定區管寮里,419,69,27,23,11,10,46,605,15,620,930,66.66999817
6702100-001,安定區蘇林里,868,301,48,74,28,22,100,1441,36,1477,2120,69.61000061
6702100-002,安定區蘇厝里,755,211,67,88,23,22,98,1264,47,1311,1963,66.82500076
6703500-051,安南區大安里,1432,407,106,159,35,39,180,2358,27,2385,3548,67.22499847
6703500-024,安南區公塭里,366,108,27,34,11,6,58,610,16,626,876,71.45999908
6703500-014,安南區公親里,481,125,22,53,24,7,45,757,25,782,1123,69.62999725
6703500-036,安南區四草里,711,198,64,52,25,17,80,1147,54,1201,1761,68.19999695
6703500-048,安南區布袋里,552,182,53,56,22,24,78,967,13,980,1491,65.73000336
6703500-007,安南區安西里,1326,316,87,199,53,28,167,2176,35,2211,3175,69.75500107
6703500-037,安南區安和里,835,229,71,101,27,20,113,1396,23,1419,2130,66.62000275
6703500-006,安南區安東里,1172,289,98,118,50,21,144,1892,24,1916,2802,68.38000107
6703500-050,安南區安富里,2000,554,168,235,77,42,250,3326,60,3386,5131,65.95999908
6703500-002,安南區安順里,1623,522,146,225,68,39,198,2821,57,2878,4240,67.63999939
6703500-009,安南區安慶里,2309,608,173,271,84,58,271,3774,57,3831,5606,68.32666524
6703500-005,安南區州北里,1591,507,140,221,67,53,189,2768,37,2805,4210,66.62999725
6703500-004,安南區州南里,1729,531,148,199,74,49,258,2988,44,3032,4530,66.94999949
6703500-023,安南區佃西里,679,187,52,72,14,18,86,1108,31,1139,1803,63.16999817
6703500-022,安南區佃東里,1116,344,107,131,42,27,138,1905,45,1950,3099,62.97499847
6703500-042,安南區幸福里,1615,381,138,207,31,23,161,2556,25,2581,3632,70.98500061
6703500-001,安南區東和里,781,207,75,129,44,22,100,1358,26,1384,2035,68.01000214
6703500-013,安南區長安里,1716,410,120,184,63,44,204,2741,47,2788,4219,66.13000107
6703500-032,安南區青草里,501,109,30,40,9,14,79,782,33,815,1400,58.20999908
6703500-025,安南區南興里,659,139,45,70,22,12,77,1024,25,1049,1603,65.44000244
6703500-029,安南區城中里,352,116,40,54,14,16,82,674,8,682,993,68.68000031
6703500-028,安南區城北里,551,133,40,62,14,13,86,899,14,913,1384,65.97000122
6703500-031,安南區城西里,518,118,35,69,18,8,79,845,20,865,1284,67.37000275
6703500-027,安南區城東里,498,146,46,39,16,15,90,850,24,874,1433,60.99000168
6703500-030,安南區城南里,1037,284,72,112,44,19,182,1750,53,1803,2870,62.68499947
6703500-033,安南區砂崙里,513,107,41,44,10,8,66,789,27,816,1315,62.03499985
6703500-011,安南區原佃里,741,217,76,123,32,28,103,1320,28,1348,2052,65.69000244
6703500-016,安南區海西里,926,303,82,107,35,21,111,1585,42,1627,2479,65.61000061
6703500-041,安南區海佃里,1737,464,141,216,53,49,204,2864,48,2912,4234,68.72333272
6703500-015,安南區海東里,2017,499,163,219,77,52,230,3257,40,3297,5029,65.45666631
6703500-017,安南區海南里,769,210,74,89,25,27,103,1297,17,1314,1908,68.79999924
6703500-049,安南區國安里,920,260,68,103,23,25,106,1505,16,1521,2143,70.98000336
6703500-044,安南區梅花里,1478,426,130,197,52,54,216,2553,36,2589,3961,65.23999786
6703500-047,安南區淵中里,1240,369,98,135,45,24,162,2073,33,2106,3107,67.79999924
6703500-021,安南區淵西里,1128,334,79,121,41,9,143,1855,32,1887,2897,65.1099968
6703500-020,安南區淵東里,1564,445,127,206,58,42,190,2632,46,2678,4165,64.28499985
6703500-045,安南區理想里,1841,482,126,242,83,70,219,3063,39,3102,4461,69.52000046
6703500-008,安南區頂安里,1692,434,132,252,62,53,216,2841,39,2880,4159,69.31499863
6703500-035,安南區鹿耳里,282,116,35,37,11,18,46,545,15,560,855,65.5
6703500-019,安南區塩田里,416,215,53,59,15,36,82,876,26,902,1359,66.37000275
6703500-003,安南區塭南里,1769,452,127,206,67,42,228,2891,63,2954,4389,67.29999924
6703500-010,安南區新順里,2081,671,178,287,96,53,284,3650,46,3696,5557,66.41333262
6703500-018,安南區溪心里,2282,634,212,294,96,96,266,3880,55,3935,6611,59.98666763
6703500-038,安南區溪北里,1047,340,122,123,44,34,157,1867,30,1897,2699,70.48500061
6703500-046,安南區溪東里,1307,454,136,193,64,59,191,2404,39,2443,3541,68.94499969
6703500-039,安南區溪頂里,1641,552,163,220,71,60,230,2937,43,2980,4264,69.78666687
6703500-040,安南區溪墘里,1183,346,89,133,46,34,174,2005,35,2040,3011,67.75500107
6703500-043,安南區鳳凰里,1557,462,142,214,62,54,195,2686,30,2716,4269,63.70000076
6703500-026,安南區學東里,684,165,78,66,15,14,105,1127,47,1174,2007,58.5
6703500-012,安南區總頭里,755,182,47,63,18,16,87,1168,28,1196,1775,67.37999725
6703500-034,安南區顯宮里,439,234,44,48,20,19,84,888,28,916,1394,65.70999908
6701400-010,西港區永樂里,423,80,25,33,11,6,46,624,18,642,1007,63.75
6701400-009,西港區竹林里,513,113,25,40,10,12,39,752,28,780,1180,66.09999847
6701400-001,西港區西港里,1297,338,91,117,30,27,177,2077,33,2110,3131,67.96000163
6701400-007,西港區金砂里,350,66,21,23,5,9,41,515,23,538,780,68.97000122
6701400-002,西港區南海里,1052,175,44,80,24,19,100,1494,59,1553,2336,66.70500183
6701400-005,西港區後營里,617,121,18,49,13,8,86,912,34,946,1397,67.72000122
6701400-003,西港區港東里,586,160,46,57,8,16,84,957,26,983,1491,66.63000107
6701400-011,西港區新復里,412,122,45,22,6,5,62,674,14,688,1057,66.70499802
6701400-008,西港區劉厝里,573,117,31,41,11,9,51,833,15,848,1264,67.08999634
6701400-012,西港區慶安里,1720,470,115,198,55,44,196,2798,54,2852,4259,67.4366684
6701400-004,西港區檨林里,668,130,37,37,13,5,82,972,22,994,1541,64.46999931
6701400-006,西港區營西里,509,97,29,42,13,10,74,774,30,804,1314,61.18999863
6701200-021,佳里區三協里,410,82,33,34,9,10,50,628,22,650,946,68.70999908
6701200-020,佳里區子龍里,674,130,35,38,11,12,50,950,24,974,1474,66.07500076
6701200-006,佳里區六安里,1384,486,109,143,62,53,170,2407,24,2431,3864,63.06000137
6701200-019,佳里區民安里,639,130,39,36,9,9,73,935,12,947,1404,67.44999695
6701200-005,佳里區安西里,3900,1357,298,475,159,179,521,6889,104,6993,10834,64.58857128
6701200-007,佳里區佳化里,799,197,57,78,17,21,108,1277,26,1303,2053,63.41500092
6701200-002,佳里區忠仁里,1065,284,84,114,28,31,131,1737,39,1776,2776,64.13499832
6701200-001,佳里區東寧里,668,242,50,75,25,29,101,1190,12,1202,1794,67.07499695
6701200-004,佳里區建南里,2931,890,214,317,113,122,387,4974,97,5071,7976,63.50599899
6701200-012,佳里區海澄里,557,143,25,41,19,15,85,885,17,902,1432,62.99000168
6701200-017,佳里區蚶寮里,359,48,24,19,11,3,41,505,12,517,830,62.29000092
6701200-016,佳里區通興里,436,74,25,21,8,7,43,614,18,632,991,63.77000046
6701200-014,佳里區頂廍里,344,115,30,17,9,7,41,563,12,575,871,66.01999664
6701200-011,佳里區溪州里,130,51,9,17,8,7,15,237,4,241,384,62.75999832
6701200-015,佳里區嘉福里,392,89,23,20,12,5,33,574,18,592,907,65.26999664
6701200-013,佳里區漳洲里,292,61,17,18,1,6,37,432,26,458,710,64.51000214
6701200-009,佳里區興化里,540,112,31,30,18,6,60,797,14,811,1239,65.45999908
6701200-018,佳里區龍安里,439,104,25,31,11,15,49,674,15,689,1030,66.88999939
6701200-010,佳里區營頂里,248,71,17,18,5,4,43,406,8,414,657,63.00999832
6701200-008,佳里區禮化里,397,85,26,33,17,6,40,604,9,613,920,66.62999725
6701200-003,佳里區鎮山里,2150,628,164,220,81,68,233,3544,51,3595,5483,65.84499931
6701000-002,官田區二鎮里,1305,162,65,112,45,24,162,1875,28,1903,2911,65.35499954
6701000-005,官田區大崎里,178,50,15,4,4,3,21,275,6,281,440,63.86000061
6701000-010,官田區西庄里,343,9,3,18,9,3,37,422,11,433,629,68.83999634
6701000-001,官田區官田里,798,240,83,72,31,14,115,1353,26,1379,2021,68.24000168
6701000-011,官田區拔林里,200,56,29,12,7,2,27,333,4,337,535,62.99000168
6701000-009,官田區東庄里,715,38,12,44,8,3,71,891,13,904,1283,70.45999908
6701000-013,官田區社子里,403,53,19,16,5,5,48,549,11,560,885,63.27999878
6701000-008,官田區南廍里,476,93,24,41,17,17,53,721,11,732,1138,64.31999969
6701000-012,官田區渡頭里,839,203,125,75,18,20,129,1409,30,1439,2112,67.76333364
6701000-003,官田區湖山里,503,59,29,28,8,0,46,673,12,685,967,70.83999634
6701000-007,官田區隆本里,1040,512,112,107,45,32,152,2000,47,2047,3118,65.60333252
6701000-006,官田區隆田里,679,292,53,65,17,17,111,1234,21,1255,1870,67.06999969
6701000-004,官田區嘉南里,87,38,10,6,1,3,24,169,3,172,272,63.24000168
6700600-004,東山區三榮里,351,73,21,21,8,5,40,519,15,534,913,58.49000168
6700600-005,東山區大客里,322,95,36,27,3,9,53,545,24,569,1078,52.77999878
6700600-009,東山區水雲里,135,19,11,9,3,4,18,199,2,201,407,49.38999939
6700600-001,東山區東山里,397,182,38,39,17,10,77,760,22,782,1404,55.70000076
6700600-002,東山區東中里,762,302,78,67,24,34,144,1411,24,1435,2372,60.5
6700600-003,東山區東正里,508,121,48,27,8,17,78,807,35,842,1455,57.92500114
6700600-007,東山區東河里,346,64,20,23,6,6,39,504,16,520,877,59.29000092
6700600-011,東山區東原里,656,239,78,36,14,11,121,1155,45,1200,2177,55.18000031
6700600-010,東山區林安里,148,26,7,3,4,4,20,212,8,220,360,61.11000061
6700600-014,東山區青山里,311,122,50,17,11,6,58,575,30,605,1067,56.70000076
6700600-013,東山區南勢里,307,104,40,22,14,7,58,552,27,579,1119,51.74000168
6700600-008,東山區南溪里,113,28,29,15,1,2,37,225,20,245,441,55.56000137
6700600-006,東山區科里里,458,144,25,24,10,12,73,746,33,779,1260,62.13499832
6700600-015,東山區高原里,218,119,63,17,10,9,68,504,21,525,906,57.33999825
6700600-016,東山區聖賢里,712,175,46,45,13,19,149,1159,32,1191,1881,63.29666646
6700600-012,東山區嶺南里,203,67,12,10,4,0,46,342,20,362,708,51.13000107
6703200-038,東區大同里,925,447,109,107,48,44,192,1872,31,1903,2907,65.65000153
6703200-003,東區大智里,1781,1096,251,305,132,189,382,4136,53,4189,6287,66.63333384
6703200-028,東區大福里,620,345,62,60,45,35,96,1263,18,1281,1971,64.98999786
6703200-016,東區大德里,514,240,66,48,27,53,86,1034,14,1048,1621,64.65000153
6703200-023,東區大學里,306,187,49,66,43,55,103,809,6,815,1206,67.58000183
6703200-022,東區小東里,1179,743,163,214,112,127,259,2797,18,2815,4137,68.0633316
6703200-010,東區中西里,911,457,93,152,93,100,223,2029,19,2048,3072,66.68000031
6703200-006,東區仁和里,1339,578,188,195,79,86,235,2700,38,2738,4179,65.47999954
6703200-045,東區文聖里,1083,662,146,200,99,119,278,2587,25,2612,3727,70.20000076
6703200-037,東區成大里,558,348,76,90,47,62,119,1300,31,1331,2036,65.19000244
6703200-013,東區自強里,1360,730,171,228,130,116,303,3038,29,3067,4711,65.10000102
6703200-014,東區和平里,1431,655,166,206,96,113,249,2916,27,2943,4368,67.35499954
6703200-029,東區忠孝里,1081,790,175,194,107,174,250,2771,33,2804,4236,66.85666911
6703200-008,東區東光里,1271,908,174,258,149,155,309,3224,36,3260,4767,68.3233312
6703200-011,東區東安里,476,211,50,69,31,23,76,936,12,948,1451,65.33000183
6703200-031,東區東明里,848,492,116,161,107,104,169,1997,13,2010,3052,65.85499954
6600200-009,東區東門里,622,282,37,69,46,36,134,1226,19,1245,1879,66.29000092
6703200-033,東區東智里,671,410,71,82,43,68,119,1464,26,1490,2180,68.33499908
6703200-034,東區東聖里,749,324,95,92,50,50,127,1487,18,1505,2243,67.09999847
6703200-025,東區虎尾里,1444,711,189,229,105,122,286,3086,38,3124,4618,67.8233312
6703200-044,東區南聖里,699,405,99,139,59,62,167,1630,18,1648,2305,71.48999786
6703200-007,東區後甲里,914,514,87,122,42,90,126,1895,33,1928,2850,67.68000031
6703200-005,東區泉南里,1382,701,151,231,121,108,281,2975,57,3032,4636,65.41333008
6703200-041,東區崇文里,1642,873,208,315,150,215,319,3722,29,3751,5624,66.76000023
6703200-035,東區崇成里,850,471,95,113,72,80,148,1829,36,1865,2744,67.95999908
6703200-012,東區崇明里,992,653,143,198,139,133,276,2534,19,2553,3845,66.28499985
6703200-040,東區崇信里,1170,513,129,172,87,84,224,2379,22,2401,4283,56.27999878
6703200-019,東區崇善里,1545,721,170,227,113,88,291,3155,44,3199,4664,68.61666361
6703200-030,東區崇誨里,648,481,110,89,64,149,145,1686,21,1707,2484,68.85499954
6703200-032,東區崇德里,1306,756,182,213,111,106,269,2943,29,2972,4353,68.24666595
6703200-004,東區崇學里,918,442,75,170,84,72,184,1945,17,1962,2813,69.90999985
6703200-027,東區莊敬里,1028,569,175,163,117,126,212,2390,34,2424,3531,68.68500137
6703200-021,東區圍下里,586,309,70,95,64,38,134,1296,10,1306,1969,66.02499962
6703200-020,東區富強里,1459,648,145,210,108,96,263,2929,39,2968,4337,68.44000244
6703200-001,東區富裕里,721,309,60,91,46,34,119,1380,19,1399,2145,65.22000122
6703200-042,東區復興里,1101,465,102,173,75,65,213,2194,25,2219,3228,68.74499893
6703200-009,東區新東里,723,398,77,120,67,78,145,1608,24,1632,2373,68.84000015
6703200-043,東區裕聖里,1048,676,210,233,125,155,249,2696,21,2717,3861,70.38000107
6703200-002,東區裕農里,911,430,109,112,74,75,189,1900,32,1932,2880,67.10499954
6703200-015,東區路東里,400,309,64,64,49,54,89,1029,11,1040,1548,67.18000031
6703200-039,東區德光里,1025,636,157,205,112,126,246,2507,21,2528,3743,67.53499985
6703200-026,東區德高里,983,414,87,130,53,42,176,1885,35,1920,2768,69.29000092
6703200-018,東區衛國里,452,243,63,63,24,37,95,977,17,994,1511,65.77999878
6703200-024,東區龍山里,1202,655,137,252,150,102,299,2797,19,2816,4148,68.09999847
6703200-017,東區關聖里,1142,708,151,210,107,143,269,2730,25,2755,3954,69.64500046
6702500-002,南化區小崙里,234,114,62,19,6,6,20,461,14,475,792,59.97000122
6702500-003,南化區中坑里,107,73,43,12,3,3,18,259,7,266,448,59.38000107
6702500-004,南化區北平里,196,70,62,19,0,2,23,372,7,379,558,67.91999817
6702500-007,南化區北寮里,300,194,99,27,11,9,63,703,16,719,1167,61.61000061
6702500-008,南化區玉山里,255,101,124,13,4,9,60,566,13,579,1000,57.90000153
6702500-006,南化區西埔里,227,112,60,25,2,7,27,460,11,471,786,59.91999817
6702500-005,南化區東和里,195,67,41,2,3,4,56,368,12,380,679,55.95999908
6702500-001,南化區南化里,426,226,131,33,11,8,64,899,32,931,1378,67.55999756
6702500-009,南化區關山里,176,62,68,18,7,3,42,376,12,388,804,48.25999832
6703300-004,南區大成里,289,116,28,34,19,19,46,551,5,556,780,71.27999878
6703300-022,南區大忠里,1453,708,180,198,104,97,239,2979,48,3027,4413,68.45999908
6703300-021,南區大林里,615,431,78,94,52,88,143,1501,14,1515,2217,68.375
6703300-023,南區大恩里,1029,606,115,138,71,104,170,2233,31,2264,3334,67.94500351
6703300-035,南區文南里,1810,619,195,247,82,86,254,3293,36,3329,4913,68.13999939
6703300-027,南區文華里,1192,487,108,179,58,50,157,2231,29,2260,3293,68.64999771
6703300-010,南區日新里,824,283,77,88,27,31,90,1420,15,1435,2012,71.33999634
6703300-038,南區永寧里,831,176,39,61,21,14,96,1238,29,1267,1800,70.59500122
6703300-008,南區田寮里,1120,511,115,131,53,63,187,2180,24,2204,3213,68.57666524
6703300-012,南區白雪里,749,220,45,72,22,17,68,1193,17,1210,1743,69.41999817
6703300-011,南區光明里,1709,489,133,165,40,59,216,2811,48,2859,4160,68.72333018
6703300-025,南區再興里,817,307,77,122,50,36,128,1537,27,1564,2297,68.06000137
6703300-019,南區同安里,996,221,67,99,30,25,78,1516,24,1540,2169,71.0399971
6703300-001,南區竹溪里,463,249,58,75,52,63,107,1067,16,1083,1599,67.73000336
6703300-020,南區佛壇里,1123,204,51,106,31,20,128,1663,30,1693,2404,70.42499924
6703300-034,南區府南里,1605,646,159,202,76,97,225,3010,45,3055,4524,67.64999898
6703300-013,南區明亮里,1450,468,123,160,67,46,172,2486,35,2521,3600,69.96666463
6703300-003,南區明德里,116,132,34,34,10,20,32,378,12,390,650,60
6703300-026,南區明興里,1367,368,85,145,30,48,171,2214,46,2260,3274,69.05499649
6703300-037,南區松安里,768,142,62,75,22,19,90,1178,18,1196,1746,68.42499924
6703300-028,南區金華里,1781,649,174,243,86,77,246,3256,35,3291,4949,66.47666931
6703300-029,南區南都里,805,342,70,110,32,36,123,1518,20,1538,2693,59.03500175
6703300-039,南區南華里,874,342,86,124,32,27,123,1608,23,1631,2436,66.97999954
6703300-032,南區建南里,1941,650,179,264,65,79,244,3422,52,3474,4846,71.68333181
6703300-017,南區省躬里,1264,263,80,102,45,37,117,1908,34,1942,2760,70.37999725
6703300-002,南區荔宅里,29,80,11,7,2,13,11,153,6,159,233,68.23999786
6703300-033,南區郡南里,1306,413,137,193,54,68,171,2342,25,2367,3493,67.63999939
6703300-009,南區國宅里,1134,363,94,119,59,59,139,1967,39,2006,2933,68.40000153
6703300-015,南區喜北里,1033,205,54,75,26,17,91,1501,32,1533,2170,70.70500183
6703300-014,南區喜東里,913,146,48,100,38,22,78,1345,21,1366,1959,69.73000336
6703300-016,南區喜南里,661,73,18,38,16,3,59,868,27,895,1271,70.41999817
6703300-030,南區開南里,2051,686,236,240,75,82,288,3658,45,3703,5674,65.2533315
6703300-024,南區新生里,440,885,157,101,71,237,197,2088,43,2131,3259,65.40499878
6703300-006,南區新昌里,775,289,90,116,47,55,113,1485,19,1504,2278,65.94499969
6703300-007,南區新興里,905,368,105,126,45,60,161,1770,26,1796,2711,66.33499908
6703300-031,南區彰南里,621,213,51,84,27,30,71,1097,28,1125,1643,68.59000015
6703300-005,南區廣州里,938,276,81,93,48,28,101,1565,17,1582,2247,70.34999847
6703300-018,南區興農里,923,217,45,93,20,16,82,1396,37,1433,2017,71.02500153
6703300-036,南區鯤鯓里,700,244,35,55,23,22,79,1158,28,1186,1786,66.15999985
6700500-004,後壁區土溝里,531,108,37,43,12,13,81,825,24,849,1302,64.55000114
6700500-009,後壁區仕安里,215,42,13,9,2,4,33,318,6,324,532,60.90000153
6700500-021,後壁區平安里,351,123,18,28,12,10,63,605,32,637,972,65.52999878
6700500-010,後壁區竹新里,654,104,39,36,10,3,104,950,24,974,1391,69.97499847
6700500-013,後壁區長安里,442,184,22,39,14,8,54,763,21,784,1212,64.72000122
6700500-002,後壁區侯伯里,531,129,35,44,16,9,86,850,19,869,1318,65.77000046
6700500-016,後壁區後廍里,132,51,13,12,5,5,34,252,15,267,437,61.09999847
6700500-001,後壁區後壁里,554,219,30,69,21,26,124,1043,16,1059,1626,65.17499924
6700500-008,後壁區崁頂里,187,34,6,16,6,5,26,280,5,285,463,61.56000137
6700500-015,後壁區烏樹里,298,63,17,15,8,7,41,449,5,454,714,63.59000015
6700500-012,後壁區頂安里,432,178,35,42,18,13,75,793,14,807,1244,64.87000275
6700500-020,後壁區頂長里,233,51,8,12,3,2,28,337,9,346,498,69.48000336
6700500-007,後壁區菁豊里,256,75,17,24,6,8,50,436,14,450,739,60.88999939
6700500-018,後壁區菁寮里,119,57,5,11,4,5,32,233,9,242,380,63.68000031
6700500-011,後壁區新東里,599,163,51,45,13,10,107,988,30,1018,1620,63.36499977
6700500-019,後壁區新嘉里,442,70,22,27,14,10,45,630,26,656,1037,63.15499878
6700500-006,後壁區嘉民里,500,84,25,25,9,21,61,725,16,741,1144,64.76999664
6700500-005,後壁區嘉田里,453,84,28,35,8,11,79,698,16,714,1127,63.34999847
6700500-003,後壁區嘉苳里,482,136,34,35,8,16,57,768,30,798,1242,65.42000198
6700500-014,後壁區福安里,420,149,37,31,18,19,69,743,15,758,1197,63.31999969
6700500-017,後壁區墨林里,269,96,14,18,6,4,42,449,14,463,718,64.48000336
6700400-006,柳營區人和里,242,79,30,33,7,21,70,482,24,506,755,67.14500046
6700400-005,柳營區八翁里,487,150,52,28,9,9,82,817,23,840,1313,63.97999954
6700400-001,柳營區士林里,565,166,71,70,26,19,80,997,21,1018,1602,63.54500008
6700400-010,柳營區大農里,235,72,17,15,9,6,46,400,15,415,667,62.22000122
6700400-003,柳營區中埕里,290,94,36,34,13,9,33,509,6,515,808,63.74000168
6700400-007,柳營區太康里,564,169,50,52,18,16,95,964,18,982,1492,65.84500122
6700400-002,柳營區光福里,670,244,65,77,22,29,92,1199,26,1225,1819,67.28499985
6700400-013,柳營區旭山里,535,152,46,42,13,13,90,891,38,929,1613,58.80666733
6700400-004,柳營區東昇里,969,310,79,110,34,37,154,1693,42,1735,2669,65.14500237
6700400-012,柳營區果毅里,425,82,29,54,22,12,125,749,11,760,1224,65.60000229
6700400-008,柳營區重溪里,687,172,47,69,11,19,111,1116,28,1144,1774,64.66999817
6700400-011,柳營區神農里,547,122,23,42,29,12,90,865,25,890,1402,66.16999817
6700400-009,柳營區篤農里,516,128,22,44,13,18,90,831,25,856,1309,65.46000099
6701600-012,將軍區三吉里,171,47,15,5,1,4,29,272,5,277,445,62.25
6701600-008,將軍區仁和里,323,40,12,18,3,5,42,443,6,449,647,69.40000153
6701600-009,將軍區北埔里,259,42,10,9,1,6,34,361,6,367,587,62.52000046
6701600-016,將軍區平沙里,455,63,18,19,0,9,56,620,15,635,1158,54.84000015
6701600-013,將軍區玉山里,388,51,10,15,4,2,46,516,12,528,865,61.04000092
6701600-003,將軍區西和里,355,86,20,30,13,12,63,579,8,587,959,61.20999908
6701600-002,將軍區西華里,527,171,30,47,10,17,67,869,13,882,1373,64.23999786
6701600-004,將軍區忠興里,569,172,30,44,18,13,99,945,26,971,1575,62.06500053
6701600-015,將軍區長沙里,509,85,33,34,5,3,69,738,21,759,1362,55.27999878
6701600-001,將軍區長榮里,441,108,31,41,7,23,53,704,20,724,1062,68.16999817
6701600-006,將軍區保源里,401,96,19,34,12,4,40,606,15,621,971,64.24499893
6701600-007,將軍區苓和里,404,97,21,38,12,10,62,644,7,651,1057,61.57500076
6701600-010,將軍區將富里,236,39,7,19,2,6,38,347,15,362,635,57.00999832
6701600-011,將軍區將貴里,222,39,12,12,9,7,36,337,13,350,587,59.63000107
6701600-005,將軍區嘉昌里,374,57,20,23,6,5,45,530,18,548,860,64.54500008
6701600-014,將軍區廣山里,221,55,17,9,4,4,34,344,15,359,678,52.95000076
6701600-018,將軍區鯤溟里,413,52,20,10,5,10,29,539,7,546,1005,54.33000183
6701600-017,將軍區鯤鯓里,789,156,30,43,7,15,61,1101,27,1128,1889,59.46000099
6700700-018,麻豆區大山里,266,41,11,29,2,5,42,396,11,407,587,69.33999634
6700700-011,麻豆區大埕里,1136,300,76,103,37,28,160,1840,37,1877,2702,69.72999954
6700700-016,麻豆區小埤里,480,69,15,41,15,8,48,676,12,688,966,71.22000122
6700700-027,麻豆區中民里,444,44,23,31,16,3,39,600,20,620,814,76.16999817
6700700-006,麻豆區中興里,784,219,47,71,36,37,112,1306,25,1331,1936,68.67499924
6700700-010,麻豆區北勢里,565,54,20,39,13,2,47,740,15,755,1127,66.98999786
6700700-028,麻豆區安正里,429,62,17,28,2,6,45,589,19,608,896,67.86000061
6700700-025,麻豆區安西里,394,48,11,21,7,4,34,519,14,533,719,74.12999725
6700700-023,麻豆區安東里,269,61,9,20,12,7,41,419,6,425,609,69.79000092
6700700-024,麻豆區安業里,337,45,8,18,9,5,22,444,8,452,615,73.5
6700700-003,麻豆區東角里,965,270,69,100,35,33,148,1620,17,1637,2453,66.46500015
6700700-009,麻豆區油車里,1586,296,74,128,45,36,175,2340,33,2373,3383,70.15000153
6700700-002,麻豆區保安里,244,53,14,18,12,6,31,378,8,386,534,72.27999878
6700700-014,麻豆區南勢里,839,257,83,66,25,34,128,1432,31,1463,2226,66.04000092
6700700-005,麻豆區巷口里,602,203,34,75,31,13,87,1045,11,1056,1544,68.38999939
6700700-019,麻豆區海埔里,447,82,20,30,8,12,63,662,15,677,998,67.83999634
6700700-017,麻豆區埤頭里,639,75,18,33,20,11,63,859,15,874,1314,66.51000214
6700700-020,麻豆區莊禮里,246,27,14,14,1,3,25,330,7,337,489,68.91999817
6700700-022,麻豆區麻口里,513,69,18,41,7,6,53,707,9,716,1048,68.31999969
6700700-021,麻豆區港尾里,553,100,28,23,14,11,71,800,16,816,1210,67.44000244
6700700-008,麻豆區新建里,532,111,18,32,17,10,42,762,11,773,1122,68.88999939
6700700-015,麻豆區寮廍里,773,99,36,49,20,9,79,1065,39,1104,1596,69.16999817
6700700-001,麻豆區穀興里,309,63,11,32,10,8,32,465,8,473,653,72.43000031
6700700-029,麻豆區磚井里,570,79,29,33,17,8,59,795,13,808,1156,69.90000153
6700700-007,麻豆區興農里,625,122,34,72,22,15,79,969,20,989,1446,68.40000153
6700700-013,麻豆區龍泉里,380,56,17,35,9,9,38,544,10,554,769,72.04000092
6700700-012,麻豆區總榮里,266,88,16,22,10,10,45,457,12,469,640,73.27999878
6700700-026,麻豆區謝安里,422,61,19,29,10,3,58,602,12,614,856,71.73000336
6700700-004,麻豆區晉江里,1074,250,48,101,50,13,134,1670,22,1692,2401,70.52000046
6701900-021,善化區小新里,1881,633,178,304,101,42,301,3440,61,3501,5419,64.7133344
6701900-011,善化區什乃里,505,114,22,67,20,20,55,803,6,809,1170,69.15000153
6701900-013,善化區六分里,319,68,27,32,10,13,34,503,5,508,708,71.75
6701900-014,善化區六德里,468,85,24,32,11,9,52,681,19,700,1071,65.36000061
6701900-008,善化區文正里,585,174,43,70,21,11,89,993,25,1018,1489,68.37000275
6701900-004,善化區文昌里,878,312,88,106,44,35,126,1589,35,1624,2568,62.93499947
6701900-018,善化區牛庄里,535,159,29,69,26,20,114,952,23,975,1446,67.43000031
6701900-007,善化區北關里,175,65,12,20,7,9,33,321,10,331,499,66.33000183
6701900-015,善化區田寮里,747,168,37,52,16,12,62,1094,27,1121,1677,66.75999832
6701900-003,善化區光文里,1644,722,151,270,108,87,275,3257,43,3300,5011,65.70666758
6701900-006,善化區西關里,256,90,18,29,10,9,29,441,6,447,674,66.31999969
6701900-002,善化區坐駕里,1226,514,118,175,85,63,215,2396,32,2428,3606,67.38000107
6701900-017,善化區東昌里,438,83,25,30,12,13,57,658,30,688,1040,66.15000153
6701900-016,善化區東隆里,359,97,16,26,4,6,56,564,15,579,861,67.25
6701900-001,善化區東關里,362,130,28,50,27,18,71,686,12,698,1083,64.44999695
6701900-005,善化區南關里,669,176,41,79,27,13,92,1097,17,1114,1650,67.51999664
6701900-010,善化區胡厝里,678,127,48,40,41,10,94,1038,22,1060,1546,68.55999756
6701900-009,善化區胡家里,595,75,24,49,14,9,56,822,19,841,1222,68.81999969
6701900-012,善化區溪美里,664,212,41,86,34,44,116,1197,23,1220,1824,66.95499802
6701900-019,善化區嘉北里,642,147,49,62,19,16,90,1025,28,1053,1544,68.19999695
6701900-020,善化區嘉南里,465,102,15,28,5,3,53,671,16,687,1008,68.15000153
6701800-017,新化區大坑里,211,34,7,11,7,12,33,315,9,324,468,69.23000336
6701800-016,新化區山脚里,482,166,68,53,20,15,101,905,33,938,1419,66.09999847
6701800-005,新化區中央里,139,64,17,11,9,4,15,259,8,267,395,67.58999634
6701800-004,新化區太平里,1525,552,168,188,57,61,219,2770,66,2836,4151,68.40500259
6701800-011,新化區北勢里,489,176,84,60,26,11,67,913,17,930,1368,67.98000336
6701800-013,新化區全興里,843,351,110,106,59,48,152,1669,29,1698,2580,65.60000038
6701800-007,新化區竹林里,153,53,23,22,6,9,28,294,4,298,419,71.12000275
6701800-019,新化區羊林里,317,88,33,18,12,9,39,516,20,536,904,59.29000092
6701800-009,新化區協興里,1102,455,109,82,46,39,170,2003,37,2040,3188,64.1299998
6701800-002,新化區東榮里,1256,569,177,144,38,56,215,2455,43,2498,3834,65.09000015
6701800-001,新化區武安里,554,272,103,55,31,30,107,1152,19,1171,1769,66.125
6701800-015,新化區知義里,765,276,86,68,22,23,113,1353,39,1392,2161,64.12500191
6701800-010,新化區唪口里,810,217,77,89,31,19,96,1339,28,1367,2014,67.93500137
6701800-014,新化區崙頂里,741,205,91,88,23,16,86,1250,26,1276,1855,68.78499985
6701800-008,新化區清水里,328,137,35,42,13,17,50,622,12,634,929,68.25
6701800-018,新化區𦰡拔里,701,247,81,63,20,33,112,1257,33,1290,2102,61.39499855
6701800-020,新化區礁坑里,461,65,34,36,2,5,51,654,19,673,1005,66.97000122
6701800-012,新化區豐榮里,995,412,101,121,54,39,163,1885,37,1922,2896,65.84999847
6701800-003,新化區護國里,501,309,67,56,28,25,91,1077,11,1088,1774,61.76000023
6701800-006,新化區觀音里,176,91,26,23,8,4,29,357,10,367,549,66.84999847
6702000-006,新市區三舍里,561,139,55,42,40,11,73,921,18,939,1420,66.12999725
6702000-008,新市區大社里,1805,372,121,163,68,28,213,2770,67,2837,4162,68.14666748
6702000-004,新市區大洲里,308,50,19,18,6,4,38,443,12,455,658,69.15000153
6702000-007,新市區大營里,1101,403,111,112,54,30,154,1965,31,1996,3044,65.50333405
6702000-011,新市區永就里,965,400,120,135,38,29,149,1836,34,1870,2680,69.96333313
6702000-003,新市區社內里,974,180,81,91,33,15,133,1507,27,1534,2188,69.90000153
6702000-010,新市區港墘里,1298,360,88,129,54,27,185,2141,41,2182,3202,67.66333389
6702000-001,新市區新市里,950,339,65,106,34,43,151,1688,22,1710,2591,65.91666667
6702000-002,新市區新和里,2205,774,182,246,109,81,311,3908,58,3966,5853,67.77200012
6702000-009,新市區潭頂里,765,187,53,46,28,6,75,1160,26,1186,1701,69.72499847
6702000-005,新市區豐華里,351,93,24,37,10,5,53,573,11,584,889,65.69000244
6700100-003,新營區三仙里,810,423,97,112,51,36,189,1718,28,1746,2788,62.70499992
6700100-010,新營區土庫里,536,111,39,38,25,17,142,908,22,930,1418,65.58999634
6700100-007,新營區大宏里,885,457,108,137,55,56,196,1894,36,1930,2978,64.92333349
6700100-009,新營區中營里,360,154,37,56,12,24,72,715,14,729,1137,64.12000275
6700100-025,新營區五興里,339,54,25,25,4,24,68,539,24,563,931,60.47000122
6700100-019,新營區太北里,670,144,40,65,22,9,86,1036,27,1063,1650,64.41999817
6700100-018,新營區太南里,566,88,46,50,5,8,77,840,31,871,1424,61.16999817
6700100-008,新營區王公里,1177,599,116,159,70,65,260,2446,36,2482,3992,62.20000076
6700100-014,新營區民生里,968,439,110,140,70,57,163,1947,33,1980,3182,62.06500053
6700100-015,新營區民榮里,1297,547,148,161,56,81,254,2544,43,2587,4262,60.78666687
6700100-002,新營區民權里,645,382,82,88,53,80,121,1451,20,1471,2358,62.36499977
6700100-006,新營區永生里,262,140,40,54,19,19,70,604,10,614,948,64.76999664
6700100-004,新營區好平里,230,96,34,28,8,15,55,466,10,476,772,61.65999985
6700100-023,新營區角帶里,140,43,8,12,7,4,28,242,11,253,417,60.66999817
6700100-026,新營區姑爺里,235,43,15,13,3,3,44,356,10,366,546,67.02999878
6700100-005,新營區延平里,392,142,32,42,10,20,62,700,19,719,1129,63.68000031
6700100-001,新營區忠政里,1236,815,152,195,110,133,259,2900,26,2926,4574,64.23333232
6700100-020,新營區南紙里,987,480,181,136,52,74,177,2087,36,2123,3482,60.94499969
6700100-012,新營區南興里,704,337,100,71,28,52,138,1430,28,1458,2428,60.22999954
6700100-016,新營區埤寮里,542,166,66,53,26,23,121,997,31,1028,1635,62.86999893
6700100-027,新營區新北里,1234,665,158,197,114,94,207,2669,42,2711,4387,61.78999964
6700100-029,新營區新東里,1513,828,211,267,136,164,364,3483,43,3526,5444,64.79333242
6700100-028,新營區新南里,1248,578,195,208,79,103,260,2671,46,2717,4280,63.62666575
6700100-021,新營區嘉芳里,579,165,65,77,29,17,121,1053,20,1073,1713,62.63999939
6700100-011,新營區興安里,134,46,27,16,7,12,17,259,3,262,389,67.34999847
6700100-013,新營區興業里,356,268,68,54,29,39,87,901,19,920,1412,65.16000366
6700100-022,新營區舊廍里,139,24,6,8,2,7,19,205,7,212,303,69.97000122
6700100-017,新營區護鎮里,500,150,41,64,14,11,75,855,20,875,1345,65.05999756
6700100-024,新營區鐵線里,271,77,21,16,12,1,52,450,19,469,708,66.23999786
6702400-007,楠西區東勢里,569,336,219,38,21,20,94,1297,35,1332,2212,60.23999977
6702400-003,楠西區密枝里,159,83,89,13,2,7,39,392,12,404,714,56.58000183
6702400-005,楠西區鹿田里,239,142,82,25,9,13,44,554,16,570,970,58.75999832
6702400-001,楠西區楠西里,407,273,223,31,10,17,89,1050,30,1080,1841,58.68499947
6702400-004,楠西區照興里,228,131,107,15,10,5,40,536,20,556,996,55.81999969
6702400-006,楠西區龜丹里,196,57,89,10,3,2,33,390,15,405,657,61.63999939
6702400-002,楠西區灣丘里,262,144,132,14,6,10,51,619,14,633,1153,54.90000153
6701300-012,學甲區三慶里,552,138,33,26,10,8,63,830,31,861,1421,60.65999985
6701300-011,學甲區大灣里,390,97,26,27,7,15,44,606,16,622,999,62.25999832
6701300-013,學甲區中洲里,548,139,31,20,16,18,80,852,31,883,1424,61.60000038
6701300-001,學甲區仁得里,1481,414,93,172,57,40,154,2411,34,2445,3785,64.73333359
6701300-009,學甲區平和里,519,57,22,30,4,4,59,695,11,706,1078,65.48999786
6701300-003,學甲區光華里,497,74,30,32,19,7,73,732,23,755,1250,59.64500046
6701300-004,學甲區宅港里,333,70,11,15,10,3,36,478,14,492,806,61.04000092
6701300-006,學甲區秀昌里,912,236,59,92,24,33,105,1461,30,1491,2318,64.29333115
6701300-007,學甲區明宜里,797,169,45,78,27,19,104,1239,14,1253,1934,65.1099968
6701300-005,學甲區慈福里,729,248,62,63,10,20,99,1231,18,1249,1916,65.21666463
6701300-010,學甲區新達里,775,254,52,48,20,18,116,1283,17,1300,2125,61.76000023
6701300-002,學甲區新榮里,856,185,45,68,26,26,92,1298,20,1318,2057,64.08500099
6701300-008,學甲區豐和里,558,67,32,34,8,5,56,760,17,777,1236,62.86000061
6703000-002,龍崎區土崎里,245,71,21,10,3,4,47,401,19,420,650,64.62000275
6703000-006,龍崎區大坪里,99,63,10,10,2,11,20,215,7,222,321,69.16000366
6703000-003,龍崎區中坑里,68,24,4,5,0,0,3,104,1,105,166,63.25
6703000-005,龍崎區牛埔里,142,36,12,5,4,8,20,227,7,234,345,67.83000183
6703000-008,龍崎區石𥕢里,141,51,20,9,0,3,18,242,8,250,421,59.38000107
6703000-001,龍崎區崎頂里,444,135,26,23,10,13,58,709,24,733,1098,66.76000214
6703000-004,龍崎區楠坑里,131,53,10,12,5,4,20,235,4,239,354,67.51000214
6703000-007,龍崎區龍船里,135,77,36,10,5,2,19,284,12,296,437,67.73000336
6702800-014,歸仁區七甲里,1208,300,109,124,44,51,161,1997,40,2037,2920,69.78000259
6702800-013,歸仁區八甲里,987,318,65,98,36,40,118,1662,51,1713,2453,69.86500168
6702800-017,歸仁區大廟里,1111,301,78,118,41,22,121,1792,35,1827,2616,70.08499908
6702800-011,歸仁區大潭里,749,164,41,80,24,11,104,1173,33,1206,1728,69.69499969
6702800-002,歸仁區六甲里,1376,338,83,118,55,34,190,2194,40,2234,3587,62.73333359
6702800-021,歸仁區文化里,1073,366,83,149,46,40,174,1931,24,1955,2889,67.69499969
6702800-016,歸仁區西埔里,726,175,42,65,27,13,116,1164,21,1185,1662,71.125
6702800-010,歸仁區沙崙里,269,86,10,14,8,6,34,427,19,446,668,66.76999664
6702800-012,歸仁區武東里,561,183,39,64,23,17,81,968,17,985,1781,55.31000137
6702800-001,歸仁區南保里,2207,707,145,280,108,59,290,3796,82,3878,5723,67.78249931
6702800-018,歸仁區南興里,1454,476,121,177,84,59,204,2575,51,2626,3827,68.61666616
6702800-004,歸仁區後市里,1227,399,102,138,50,37,172,2125,47,2172,3173,68.27999878
6702800-007,歸仁區看西里,786,198,52,98,43,19,123,1319,25,1344,1963,68.47000122
6702800-008,歸仁區看東里,620,236,51,90,29,25,77,1128,15,1143,1697,67.34999847
6702800-009,歸仁區崙頂里,1109,303,87,145,37,40,123,1844,58,1902,2639,72.07000351
6702800-006,歸仁區許厝里,1263,379,85,143,52,56,165,2143,35,2178,3158,69.19666799
6702800-005,歸仁區辜厝里,1192,420,80,151,40,39,149,2071,39,2110,3122,67.45666504
6702800-015,歸仁區媽廟里,850,194,46,85,19,19,112,1325,30,1355,1995,67.89500046
6702800-019,歸仁區新厝里,968,250,59,124,44,17,124,1586,31,1617,2376,68.03499985
6702800-003,歸仁區歸仁里,755,301,59,94,60,36,96,1401,24,1425,2174,65.35500145
6702800-020,歸仁區歸南里,881,263,75,96,30,28,118,1491,30,1521,2181,69.73500061
6702900-017,關廟區下湖里,185,66,12,7,7,9,23,309,16,325,458,70.95999908
6702900-002,關廟區山西里,776,232,56,89,30,25,121,1329,20,1349,2000,67.61000061
6702900-007,關廟區五甲里,1058,405,101,123,41,32,161,1921,39,1960,2940,66.67000198
6702900-011,關廟區北花里,835,211,69,70,23,22,116,1346,50,1396,2077,67.46500015
6702900-004,關廟區北勢里,911,286,80,80,40,12,141,1550,57,1607,2368,67.87000275
6702900-013,關廟區布袋里,559,139,30,31,16,10,57,842,34,876,1218,73.42999649
6702900-014,關廟區田中里,317,80,17,21,4,4,40,483,13,496,723,68.59999847
6702900-008,關廟區東勢里,1193,335,108,121,38,32,189,2016,51,2067,3024,68.35666656
6702900-009,關廟區松腳里,751,226,61,59,29,17,94,1237,24,1261,1819,69.25500107
6702900-010,關廟區南花里,564,171,52,53,20,16,77,953,21,974,1422,68.57500076
6702900-003,關廟區香洋里,1185,466,88,124,53,36,186,2138,62,2200,3270,67.45666504
6702900-016,關廟區埤頭里,709,195,55,54,18,12,92,1135,19,1154,1656,69.65499878
6702900-012,關廟區深坑里,626,204,37,51,22,11,84,1035,16,1051,1511,69.79999924
6702900-006,關廟區新光里,325,53,18,22,5,8,36,467,10,477,736,64.80999756
6702900-005,關廟區新埔里,399,113,40,20,9,11,44,636,17,653,981,66.55999756
6702900-015,關廟區龜洞里,323,97,26,23,12,4,43,528,14,542,784,69.12999725
6702900-001,關廟區關廟里,756,308,49,79,25,24,113,1354,20,1374,2001,68.625
6700200-003,鹽水區三生里,111,35,18,15,5,9,21,214,7,221,323,68.41999817
6700200-013,鹽水區下中里,277,53,14,12,2,6,45,409,16,425,743,57.20000076
6700200-020,鹽水區下林里,161,20,7,8,6,2,30,234,10,244,370,65.94999695
6700200-015,鹽水區大莊里,204,46,8,8,1,5,34,306,10,316,506,62.45000076
6700200-022,鹽水區大豐里,134,30,7,2,4,1,18,196,3,199,333,59.75999832
6700200-005,鹽水區中境里,147,87,19,13,4,10,29,309,6,315,503,62.61999893
6700200-006,鹽水區水仙里,109,55,16,8,4,1,21,214,8,222,345,64.34999847
6700200-007,鹽水區水正里,250,114,20,37,10,5,40,476,9,485,738,65.72000122
6700200-001,鹽水區水秀里,549,183,46,45,9,14,88,934,24,958,1514,62.97500038
6700200-021,鹽水區田寮里,119,21,7,5,0,3,14,169,1,170,246,69.11000061
6700200-019,鹽水區竹埔里,337,55,13,19,2,3,61,490,13,503,792,63.50999832
6700200-010,鹽水區汫水里,402,37,19,38,6,1,65,568,18,586,955,61.36000061
6700200-011,鹽水區岸內里,1146,402,125,124,43,49,202,2091,42,2133,3400,62.81999969
6700200-004,鹽水區武廟里,162,62,22,19,14,3,38,320,5,325,523,62.13999939
6700200-024,鹽水區河南里,181,51,13,9,4,7,24,289,15,304,511,59.49000168
6700200-025,鹽水區南港里,372,98,28,31,1,6,48,584,22,606,890,68.08999634
6700200-017,鹽水區後宅里,233,59,18,15,3,6,51,385,12,397,635,62.52000046
6700200-018,鹽水區孫厝里,155,36,7,10,2,7,16,233,12,245,425,57.65000153
6700200-016,鹽水區桐寮里,134,22,6,8,4,2,5,181,8,189,294,64.29000092
6700200-023,鹽水區飯店里,140,45,15,8,5,5,32,250,6,256,401,63.84000015
6700200-012,鹽水區義稠里,285,77,22,27,13,12,51,487,18,505,809,62.41999817
6700200-002,鹽水區福得里,210,80,24,27,6,9,35,391,7,398,610,65.25
6700200-008,鹽水區橋南里,1139,402,90,142,65,37,212,2087,45,2132,3569,59.89666748
6700200-009,鹽水區舊營里,348,51,9,23,7,3,37,478,10,488,765,63.79000092
6700200-014,鹽水區歡雅里,619,142,51,41,11,16,91,971,29,1000,1661,59.92000008
6400500-084,三民區力行里,453,184,40,50,14,37,79,857,8,865,1114,77.65000153
6400500-063,三民區十全里,609,198,41,74,29,34,91,1076,16,1092,1533,71.23000336
6400500-064,三民區十美里,665,231,47,85,41,32,126,1227,6,1233,1812,68.05000305
6400500-087,三民區千北里,404,156,38,46,14,18,71,747,6,753,1049,71.77999878
6400500-088,三民區千秋里,793,292,58,77,27,40,118,1405,22,1427,2034,70.15999985
6400500-085,三民區千歲里,416,150,35,53,23,66,66,809,16,825,1128,73.13999939
6400500-082,三民區川東里,473,181,33,47,21,29,62,846,11,857,1217,70.41999817
6400500-014,三民區本上里,1349,700,149,246,146,165,280,3035,25,3060,4408,69.44666799
6400500-012,三民區本元里,1636,798,169,266,137,146,325,3477,32,3509,4969,70.59666697
6400500-010,三民區本文里,754,315,54,84,42,59,109,1417,22,1439,1943,74.16999817
6400500-013,三民區本安里,1368,757,157,258,111,147,237,3035,29,3064,4268,71.79000092
6400500-009,三民區本和里,2239,1065,255,294,173,201,419,4646,69,4715,6688,70.54999924
6400500-011,三民區本武里,645,211,44,75,39,37,95,1146,18,1164,1620,71.84999847
6400500-015,三民區本揚里,2282,1130,256,378,169,210,451,4876,49,4925,6950,70.91399841
6400500-008,三民區本館里,2935,1194,299,381,169,209,490,5677,81,5758,8132,70.80800018
6400500-039,三民區正順里,1296,558,126,179,114,111,258,2642,32,2674,3735,71.61000061
6400500-038,三民區正興里,3235,1539,412,518,286,364,724,7078,98,7176,10868,65.9950002
6400500-059,三民區民享里,806,306,63,99,39,49,138,1500,19,1519,2206,68.84500122
6400500-067,三民區立業里,366,123,29,51,10,12,71,662,11,673,967,69.59999847
6400500-066,三民區立誠里,297,89,14,41,10,32,38,521,7,528,735,71.83999634
6400500-086,三民區立德里,399,197,44,44,21,35,77,817,13,830,1133,73.26000214
6400500-052,三民區同德里,1007,352,100,107,47,77,186,1876,22,1898,2696,70.5
6400500-055,三民區安生里,572,178,43,65,31,24,105,1018,15,1033,1398,73.88999939
6400500-044,三民區安吉里,1409,636,159,202,102,121,288,2917,41,2958,4546,65.19666799
6400500-062,三民區安邦里,1277,505,118,181,58,77,207,2423,19,2442,3793,65.33666865
6400500-047,三民區安和里,1005,328,76,114,62,33,174,1792,23,1815,2469,73.59000015
6400500-060,三民區安宜里,1213,408,96,170,82,68,203,2240,21,2261,3008,75.1649971
6400500-046,三民區安東里,999,439,66,154,82,77,208,2025,24,2049,2815,72.72499847
6400500-061,三民區安泰里,1365,525,125,164,77,92,230,2578,38,2616,3792,69.08000183
6400500-042,三民區安康里,1073,365,103,91,33,34,151,1850,36,1886,2818,66.97500229
6400500-045,三民區安發里,1443,696,151,221,134,145,285,3075,27,3102,4592,67.56666819
6400500-043,三民區安寧里,697,225,66,64,26,26,116,1220,24,1244,1831,67.9149971
6400500-074,三民區長明里,333,186,34,39,17,29,57,695,12,707,1061,66.63999939
6400500-075,三民區建東里,348,161,34,30,26,37,69,705,5,710,1187,59.81000137
6400500-073,三民區博惠里,1358,587,134,193,71,117,243,2703,24,2727,3967,68.71333567
6400500-072,三民區博愛里,412,181,36,59,19,33,91,831,12,843,1224,68.87000275
6400500-070,三民區港西里,238,99,16,20,11,26,53,463,9,472,752,62.77000046
6400500-068,三民區港東里,526,189,29,51,20,25,72,912,19,931,1410,66.02999878
6400500-069,三民區港新里,457,219,45,57,27,41,92,938,13,951,1378,69.01000214
6400500-083,三民區裕民里,416,190,38,56,28,26,85,839,13,852,1222,69.72000122
6400500-050,三民區達仁里,541,220,61,84,39,27,110,1082,7,1089,1476,73.77999878
6400500-049,三民區達明里,585,223,34,56,24,25,89,1036,9,1045,1472,70.98999786
6400500-051,三民區達勇里,350,153,17,35,19,46,59,679,5,684,980,69.80000305
6400500-048,三民區達德里,557,156,39,69,29,33,99,982,11,993,1314,75.56999969
6400500-004,三民區鼎力里,1278,484,107,155,89,81,195,2389,25,2414,3423,70.50999832
6400500-006,三民區鼎中里,1318,467,117,158,71,68,193,2392,19,2411,3230,74.59500122
6400500-005,三民區鼎西里,2521,897,236,307,138,180,365,4644,67,4711,6838,68.73749924
6400500-001,三民區鼎金里,1364,527,122,154,70,73,231,2541,34,2575,3883,66.36999893
6400500-007,三民區鼎泰里,5492,3199,686,921,528,725,1369,12920,121,13041,18857,69.16100082
6400500-003,三民區鼎強里,1473,517,110,159,73,72,215,2619,40,2659,3796,70.04999924
6400500-002,三民區鼎盛里,2322,1107,254,347,155,204,397,4786,57,4843,7113,67.95749855
6400500-058,三民區精華里,545,255,46,63,27,38,100,1074,12,1086,1492,72.79000092
6400500-078,三民區鳳北里,564,191,42,44,29,21,98,989,15,1004,1359,73.87999725
6400500-077,三民區鳳南里,379,120,27,39,21,21,55,662,9,671,910,73.73999786
6400500-054,三民區德仁里,657,260,74,80,56,35,120,1282,7,1289,1916,67.27999878
6400500-065,三民區德北里,672,250,40,73,34,40,135,1244,16,1260,1856,67.875
6400500-057,三民區德行里,464,152,35,47,16,34,61,809,17,826,1084,76.19999695
6400500-079,三民區德西里,277,139,24,38,14,16,46,554,16,570,816,69.84999847
6400500-056,三民區德東里,312,113,28,38,15,16,45,567,9,576,783,73.55999756
6400500-053,三民區德智里,792,346,63,127,62,60,151,1601,21,1622,2227,72.87999725
6400500-076,三民區興德里,595,235,54,56,32,61,113,1146,12,1158,1709,67.76000214
6400500-081,三民區豐裕里,927,369,83,96,35,45,139,1694,29,1723,2496,69.03499985
6400500-020,三民區寶中里,1130,415,104,120,45,63,179,2056,22,2078,2923,71.09000015
6400500-023,三民區寶民里,942,470,96,135,65,82,175,1965,25,1990,2949,67.48500061
6400500-030,三民區寶玉里,2504,1189,313,368,201,239,472,5286,72,5358,7852,68.26000061
6400500-027,三民區寶安里,2054,1059,247,303,184,215,393,4455,40,4495,6623,67.86999893
6400500-018,三民區寶泰里,1223,535,144,167,64,106,218,2457,28,2485,3783,65.70000076
6400500-029,三民區寶珠里,1733,750,145,239,96,149,267,3379,46,3425,6252,58.06333542
6400500-022,三民區寶國里,2338,1148,286,358,168,227,419,4944,67,5011,7368,67.97600021
6400500-026,三民區寶盛里,1507,721,183,255,102,163,335,3266,39,3305,4684,70.50666809
6400500-021,三民區寶華里,865,518,119,141,102,82,169,1996,22,2018,2978,67.76499939
6400500-025,三民區寶業里,1507,739,147,243,118,139,319,3212,30,3242,4736,68.36000315
6400500-016,三民區寶獅里,1179,506,127,168,83,90,243,2396,27,2423,3489,69.46999741
6400500-017,三民區寶德里,1649,655,139,228,90,137,276,3174,39,3213,4747,67.58666992
6400500-024,三民區寶慶里,853,344,87,132,56,70,140,1682,22,1704,2538,67.13999939
6400500-019,三民區寶興里,2140,928,233,281,153,132,372,4239,69,4308,6147,70.14500046
6400500-028,三民區寶龍里,1414,615,149,175,80,104,228,2765,58,2823,3987,70.82999929
6400500-031,三民區灣子里,1201,503,139,163,77,100,202,2385,23,2408,3616,66.63000107
6400500-033,三民區灣中里,1829,653,175,199,97,106,293,3352,46,3398,5159,65.86666616
6400500-041,三民區灣成里,815,346,85,87,36,64,126,1559,25,1584,2254,70.27000046
6400500-036,三民區灣利里,1289,391,89,127,62,47,183,2188,44,2232,3075,72.59500122
6400500-035,三民區灣勝里,790,242,49,58,27,24,119,1309,20,1329,1868,71.13999939
6400500-037,三民區灣復里,1180,390,127,148,62,82,188,2177,22,2199,3520,62.50999832
6400500-034,三民區灣華里,880,330,89,107,54,41,169,1670,18,1688,2592,65.11999893
6400500-032,三民區灣愛里,1047,355,87,111,44,59,136,1839,39,1878,2971,63.20499992
6400500-040,三民區灣興里,626,237,66,79,51,53,130,1242,11,1253,1774,70.62999725
6401600-005,大社區三奶里,1070,362,89,123,30,28,162,1864,34,1898,2595,73.21666463
6401600-003,大社區大社里,1792,606,158,206,77,88,277,3204,64,3268,4770,68.37249947
6401600-008,大社區中里里,1213,415,126,101,44,41,178,2118,42,2160,3087,69.7533315
6401600-009,大社區保安里,1230,389,114,115,41,48,174,2111,32,2143,3002,71.26499939
6401600-002,大社區保社里,1004,371,90,105,35,44,189,1838,40,1878,2762,68.25500107
6401600-007,大社區神農里,1758,593,172,200,70,52,257,3102,45,3147,4572,68.85333252
6401600-001,大社區嘉誠里,391,119,29,39,6,14,47,645,28,673,973,69.16999817
6401600-004,大社區翠屏里,719,180,46,72,18,29,116,1180,15,1195,1640,72.86000061
6401600-006,大社區觀音里,2025,639,155,232,95,64,302,3512,58,3570,5150,69.54999924
6401400-005,大寮區三隆里,1729,533,138,177,51,46,248,2922,64,2986,4385,68.04999924
6401400-004,大寮區上寮里,991,177,76,99,17,23,151,1534,29,1563,2261,69.125
6401400-003,大寮區大寮里,2399,648,235,240,47,73,321,3963,69,4032,6361,63.33600006
6401400-017,大寮區山頂里,2068,1247,269,264,82,198,406,4534,75,4609,7091,65.19999886
6401400-009,大寮區中庄里,3611,1303,331,400,141,174,568,6528,111,6639,10150,65.4849987
6401400-025,大寮區中興里,1423,1615,252,180,76,257,342,4145,55,4200,6434,65.36400146
6401400-002,大寮區內坑里,1871,552,207,160,52,92,255,3189,56,3245,5357,62.71000004
6401400-019,大寮區永芳里,2355,871,190,218,64,138,385,4221,85,4306,6514,66.12333488
6401400-024,大寮區光武里,32,64,7,3,0,6,11,123,4,127,186,68.27999878
6401400-022,大寮區江山里,729,215,71,60,26,31,113,1245,18,1263,1749,72.24000168
6401400-018,大寮區忠義里,122,113,26,11,4,56,29,361,5,366,556,65.83000183
6401400-008,大寮區前庄里,808,338,63,90,39,63,110,1511,25,1536,2252,68.32000351
6401400-010,大寮區後庄里,2434,1047,262,257,81,133,400,4614,73,4687,7078,66.23600006
6401400-001,大寮區拷潭里,632,105,33,53,38,9,74,944,19,963,1406,68.52999878
6401400-023,大寮區昭明里,1410,317,71,114,38,48,190,2188,45,2233,3457,64.54666901
6401400-006,大寮區琉球里,1757,434,126,177,63,58,242,2857,49,2906,4114,70.61333211
6401400-007,大寮區翁園里,1650,309,89,146,23,41,186,2444,55,2499,3527,70.87666829
6401400-012,大寮區新厝里,675,124,51,52,10,5,88,1005,36,1041,1570,66.46999741
6401400-016,大寮區會社里,1766,887,178,210,69,95,265,3470,69,3539,5858,61.30799942
6401400-015,大寮區會結里,603,201,45,39,7,14,73,982,22,1004,1513,66.36000061
6401400-021,大寮區溪寮里,619,182,36,54,21,13,95,1020,19,1039,1462,71.08499908
6401400-011,大寮區義仁里,721,228,53,57,28,20,106,1213,29,1242,1781,69.54999924
6401400-020,大寮區義和里,871,219,64,76,24,28,125,1407,36,1443,2026,71.11000061
6401400-013,大寮區過溪里,925,297,87,85,26,23,137,1580,28,1608,2384,67.22500229
6401400-014,大寮區潮寮里,1266,309,69,111,43,24,194,2016,60,2076,2908,71.38666789
6401500-002,大樹區九曲里,1607,766,135,146,54,69,258,3035,58,3093,4597,68.31999969
6401500-015,大樹區三和里,337,132,31,29,7,16,69,621,13,634,976,64.95999908
6401500-003,大樹區久堂里,1312,737,130,173,53,67,265,2737,65,2802,3896,72.1766688
6401500-010,大樹區大坑里,572,154,41,61,21,13,92,954,30,984,1396,70.48999786
6401500-014,大樹區大樹里,975,307,87,70,25,23,132,1619,30,1649,2370,69.73000336
6401500-012,大樹區小坪里,516,163,37,40,19,18,77,870,23,893,1275,70.04000092
6401500-011,大樹區井腳里,722,159,46,51,9,8,80,1075,27,1102,1557,70.80000305
6401500-004,大樹區水安里,972,296,60,92,25,26,140,1611,33,1644,2305,71.3350029
6401500-005,大樹區水寮里,1005,266,68,83,22,28,153,1625,41,1666,2227,74.80500031
6401500-001,大樹區竹寮里,936,377,106,100,33,68,153,1773,32,1805,2582,69.9149971
6401500-008,大樹區和山里,441,107,22,32,9,3,55,669,26,695,983,70.69999695
6401500-009,大樹區姑山里,424,101,25,25,12,9,68,664,16,680,952,71.43000031
6401500-018,大樹區統嶺里,289,137,11,11,3,10,38,499,12,511,710,71.97000122
6401500-016,大樹區溪埔里,612,171,34,52,28,29,119,1045,26,1071,1566,68.57999802
6401500-007,大樹區興山里,472,106,23,50,11,3,63,728,18,746,1085,68.76000214
6401500-017,大樹區興田里,602,451,29,59,12,25,100,1278,40,1318,1928,68.30500031
6401500-013,大樹區龍目里,775,141,40,58,16,10,121,1161,29,1190,1609,73.79500198
6401500-006,大樹區檨腳里,1353,435,118,122,42,43,203,2316,59,2375,3516,67.79000092
6401100-012,小港區二苓里,1369,477,93,133,58,44,201,2375,40,2415,3665,65.88999939
6401100-013,小港區三苓里,1014,408,95,132,39,50,168,1906,29,1935,2780,69.62999725
6401100-026,小港區大坪里,915,288,85,86,33,29,165,1601,35,1636,2415,67.68000031
6401100-011,小港區大苓里,882,316,97,101,54,41,162,1653,18,1671,2429,68.79499817
6401100-001,小港區小港里,917,421,94,105,44,41,156,1778,40,1818,2759,66
6401100-022,小港區山明里,3627,1310,359,471,118,154,595,6634,122,6756,10214,66.29166603
6401100-018,小港區山東里,797,458,99,114,47,118,155,1788,31,1819,2798,65.02500153
6401100-032,小港區中厝里,1214,389,95,139,30,29,195,2091,32,2123,3172,66.93000031
6401100-016,小港區六苓里,912,420,98,135,59,66,194,1884,34,1918,2919,66.41500092
6401100-028,小港區孔宅里,1421,643,176,168,79,84,264,2835,38,2873,4474,64.1766688
6401100-014,小港區正苓里,1240,558,121,181,75,87,251,2513,32,2545,3916,64.97333399
6401100-030,小港區合作里,1013,342,75,121,33,25,153,1762,28,1790,2465,72.60499954
6401100-017,小港區宏亮里,1043,381,114,133,51,48,215,1985,33,2018,3093,65.33499908
6401100-027,小港區坪頂里,1914,469,157,189,47,82,298,3156,58,3214,4980,64.58333333
6401100-010,小港區店鎮里,1948,719,165,246,96,118,302,3594,43,3637,5450,66.73999786
6401100-025,小港區松山里,1066,427,79,137,40,50,202,2001,30,2031,2921,69.54499817
6401100-024,小港區松金里,904,332,63,98,34,48,161,1640,26,1666,2418,68.90999985
6401100-019,小港區青島里,496,569,121,73,32,112,143,1546,34,1580,2371,67.20499992
6401100-031,小港區桂林里,2662,832,236,322,128,147,429,4756,69,4825,7208,66.91250038
6401100-021,小港區泰山里,1108,424,82,154,51,72,149,2040,25,2065,3048,68.20999908
6401100-023,小港區高松里,1397,476,108,128,48,56,210,2423,35,2458,3656,67.01999664
6401100-002,小港區港口里,881,523,130,128,96,120,175,2053,35,2088,3056,68.25500107
6401100-003,小港區港正里,741,476,81,127,39,75,167,1706,18,1724,2483,69.40999985
6401100-006,小港區港后里,873,295,71,103,28,42,139,1551,27,1578,2261,69.89500046
6401100-005,小港區港明里,1059,437,82,140,46,52,201,2017,30,2047,3060,66.83499908
6401100-007,小港區港南里,635,232,71,82,23,26,101,1170,27,1197,2193,54.58000183
6401100-004,小港區港墘里,610,237,52,75,32,24,103,1133,12,1145,1654,69.23000336
6401100-008,小港區港興里,864,316,73,115,38,39,110,1555,33,1588,2227,71.24499893
6401100-015,小港區順苓里,1381,607,133,182,79,92,232,2706,46,2752,4187,65.72666677
6401100-029,小港區廈莊里,1019,358,79,134,33,59,162,1844,32,1876,2777,67.99499893
6401100-036,小港區鳳林里,1117,285,64,127,47,29,193,1862,28,1890,2845,66.42499924
6401100-009,小港區鳳宮里,736,227,54,105,40,51,108,1321,26,1347,2097,64.23000336
6401100-035,小港區鳳森里,829,227,56,102,25,30,136,1405,24,1429,2082,68.63999939
6401100-038,小港區鳳源里,1329,311,91,139,37,29,172,2108,58,2166,3443,62.93499947
6401100-033,小港區鳳鳴里,1025,391,96,122,35,43,189,1901,46,1947,2922,66.69000244
6401100-037,小港區鳳興里,911,216,45,109,39,22,144,1486,30,1516,2327,65.02000046
6401100-034,小港區龍鳳里,1022,340,65,102,34,35,173,1771,46,1817,2833,64.13500214
6401100-020,小港區濟南里,1052,721,129,141,57,141,240,2481,36,2517,3772,66.74666595
6401700-009,仁武區八卦里,4807,1813,507,588,253,329,794,9091,103,9194,13772,66.78249931
6401700-001,仁武區大灣里,1433,393,121,208,44,66,219,2484,30,2514,3602,70.11000061
6401700-012,仁武區中華里,591,223,57,58,15,20,101,1065,19,1084,1590,68.18000031
6401700-013,仁武區五和里,1476,397,136,156,56,71,244,2536,42,2578,3922,65.53499985
6401700-014,仁武區仁和里,1272,450,105,146,61,85,210,2329,38,2367,3432,69.1400032
6401700-006,仁武區仁武里,1899,582,130,201,72,66,260,3210,46,3256,5105,63.87666702
6401700-016,仁武區仁慈里,738,339,45,96,47,50,112,1427,14,1441,1957,73.62999725
6401700-005,仁武區仁福里,319,83,23,18,8,9,52,512,9,521,819,63.61000061
6401700-007,仁武區文武里,3204,955,300,339,94,123,447,5462,82,5544,8114,68.28000005
6401700-008,仁武區竹後里,1031,177,61,66,21,19,128,1503,37,1540,2156,71.52000046
6401700-003,仁武區考潭里,959,400,75,91,43,45,146,1759,36,1795,2588,69.375
6401700-015,仁武區赤山里,1937,626,166,235,70,82,327,3443,47,3490,5074,68.90333303
6401700-011,仁武區後安里,1114,245,59,77,30,34,124,1683,32,1715,2446,70.14500046
6401700-004,仁武區烏林里,1296,461,117,144,32,47,185,2282,61,2343,3684,63.71333567
6401700-010,仁武區高楠里,737,197,39,47,18,21,96,1155,27,1182,1636,72.3350029
6401700-002,仁武區灣內里,2461,757,254,295,96,97,348,4308,44,4352,6502,67.09799957
6403500-014,內門區三平里,249,82,14,8,7,3,53,416,18,434,642,67.59999847
6403500-010,內門區中埔里,172,126,21,10,6,9,32,376,16,392,560,70
6403500-011,內門區內東里,269,177,31,15,9,6,56,563,26,589,823,71.56999969
6403500-007,內門區內門里,325,206,35,22,5,8,41,642,15,657,958,68.58000183
6403500-012,內門區內南里,92,66,21,12,4,8,36,239,14,253,401,63.09000015
6403500-008,內門區內豊里,387,236,50,40,6,14,71,804,42,846,1217,69.51999664
6403500-016,內門區內興里,255,37,9,20,0,5,33,359,11,370,585,63.25
6403500-015,內門區木柵里,212,75,17,16,3,4,41,368,24,392,596,65.76999664
6403500-004,內門區永吉里,151,68,12,5,3,17,22,278,11,289,422,68.48000336
6403500-003,內門區永富里,327,145,52,21,6,8,66,625,19,644,962,66.94000244
6403500-005,內門區永興里,127,71,25,5,4,1,9,242,10,252,428,58.88000107
6403500-006,內門區石坑里,172,84,21,8,2,1,22,310,13,323,490,65.91999817
6403500-018,內門區光興里,226,109,26,17,1,8,41,428,17,445,647,68.77999878
6403500-013,內門區東埔里,185,84,16,13,3,1,33,335,9,344,498,69.08000183
6403500-002,內門區金竹里,268,75,15,9,3,1,24,395,21,416,639,65.09999847
6403500-001,內門區溝坪里,268,152,33,15,5,8,57,538,25,563,979,57.50999832
6403500-017,內門區瑞山里,109,65,12,5,1,6,33,231,14,245,338,72.48999786
6403500-009,內門區觀亭里,588,291,57,44,13,28,80,1101,44,1145,1688,67.83000183
6403200-012,六龜區大津里,109,40,19,8,1,6,17,200,7,207,313,66.12999725
6403200-009,六龜區中興里,332,273,61,27,14,34,76,817,25,842,1461,57.63000107
6403200-006,六龜區六龜里,276,94,38,17,4,17,55,501,22,523,983,53.20000076
6403200-011,六龜區文武里,466,160,51,20,6,14,76,793,25,818,1495,54.72000122
6403200-005,六龜區荖濃里,387,117,51,19,4,14,72,664,50,714,1395,51.18000031
6403200-001,六龜區新威里,229,94,27,16,5,15,51,437,22,459,734,62.52999878
6403200-004,六龜區新發里,288,87,23,22,6,4,41,471,17,488,984,49.59000015
6403200-003,六龜區新寮里,232,67,22,7,2,5,57,392,20,412,619,66.55999756
6403200-002,六龜區新興里,239,71,28,11,7,5,34,395,23,418,676,61.83000183
6403200-007,六龜區義寶里,293,174,44,22,12,17,61,623,11,634,1038,61.08000183
6403200-008,六龜區興龍里,274,91,19,11,9,5,52,461,10,471,816,57.72000122
6403200-010,六龜區寶來里,239,149,26,11,36,8,63,532,15,547,915,59.77999878
6400300-004,左營區中北里,320,77,17,16,5,14,32,481,10,491,634,77.44000244
6400300-005,左營區中南里,261,38,7,18,7,6,33,370,4,374,533,70.16999817
6400300-013,左營區永清里,79,215,32,17,4,21,60,428,10,438,734,59.66999817
6400300-016,左營區光輝里,612,529,71,96,35,88,151,1582,17,1599,2370,67.49500275
6400300-017,左營區合群里,73,1018,91,26,24,303,106,1641,18,1659,2369,70.15499878
6400300-035,左營區自助里,61,99,6,18,9,28,24,245,4,249,381,65.34999847
6400300-009,左營區尾北里,1100,478,102,97,41,92,222,2132,30,2162,3225,67.38000107
6400300-002,左營區尾西里,459,129,24,38,15,18,67,750,10,760,1057,71.90000153
6400300-008,左營區尾南里,326,86,6,22,8,7,44,499,15,514,724,70.98999786
6400300-019,左營區明建里,92,157,49,22,14,111,63,508,7,515,777,66.27999878
6400300-038,左營區果峰里,149,579,58,28,19,116,111,1060,18,1078,1623,66.41999817
6400300-037,左營區果惠里,186,479,64,40,35,115,102,1021,19,1040,1519,68.47000122
6400300-036,左營區果貿里,287,834,115,73,33,233,201,1776,38,1814,2698,67.08000183
6400300-025,左營區城南里,198,70,15,14,12,10,35,354,5,359,510,70.38999939
6400300-011,左營區屏山里,257,552,90,23,30,75,131,1158,19,1177,1794,65.61000061
6400300-032,左營區海勝里,492,2033,230,111,64,498,346,3774,69,3843,5598,69.04000092
6400300-030,左營區埤北里,250,370,51,25,13,70,76,855,20,875,1333,65.63999939
6400300-029,左營區埤西里,322,157,24,25,11,20,63,622,17,639,941,67.91000366
6400300-031,左營區埤東里,364,258,48,47,15,42,112,886,19,905,1415,63.95999908
6400300-034,左營區崇實里,627,511,131,130,76,193,217,1885,14,1899,2939,64.57999802
6400300-012,左營區祥和里,33,184,15,4,0,23,15,274,7,281,372,75.54000092
6400300-015,左營區莒光里,370,425,69,47,20,90,92,1113,11,1124,1702,66.04000092
6400300-003,左營區頂北里,212,76,14,24,5,10,36,377,6,383,540,70.93000031
6400300-021,左營區頂西里,432,115,19,46,13,10,45,680,7,687,975,70.45999908
6400300-043,左營區菜公里,7223,3985,971,1120,546,845,1697,16387,169,16556,25021,66.14285605
6400300-001,左營區進學里,458,303,50,47,10,49,124,1041,20,1061,2529,41.95000076
6400300-040,左營區新上里,7062,3419,735,1099,647,860,1615,15437,144,15581,23275,67.01500034
6400300-039,左營區新下里,3339,2064,451,527,262,487,772,7902,100,8002,11859,67.5628564
6400300-041,左營區新中里,1959,585,135,212,80,96,305,3372,36,3408,4818,70.86333466
6400300-042,左營區新光里,3523,1812,407,492,251,455,846,7786,83,7869,11851,66.39499919
6400300-022,左營區聖后里,337,77,27,27,17,6,51,542,11,553,766,72.19000244
6400300-023,左營區聖西里,158,38,5,15,9,5,25,255,3,258,347,74.34999847
6400300-024,左營區聖南里,220,59,10,12,9,8,30,348,3,351,509,68.95999908
6400300-026,左營區路東里,301,88,17,29,10,10,54,509,4,513,713,71.94999695
6400300-027,左營區廍北里,216,41,7,20,2,6,33,325,8,333,445,74.83000183
6400300-028,左營區廍南里,255,82,12,25,8,8,38,428,7,435,618,70.38999939
6400300-044,左營區福山里,8065,4877,1221,1367,591,999,2116,19236,184,19420,30393,63.87312436
6400300-007,左營區廟北里,428,64,25,24,5,9,55,610,16,626,909,68.87000275
6400300-006,左營區廟東里,438,68,14,31,6,7,46,610,8,618,825,74.91000366
6402700-001,永安區永安里,458,257,58,68,15,24,85,965,25,990,1538,64.36500168
6402700-002,永安區永華里,608,318,62,60,21,24,111,1204,21,1225,1786,68.66500092
6402700-005,永安區保寧里,835,343,97,76,32,20,142,1545,45,1590,2343,68.06500244
6402700-003,永安區新港里,853,293,93,78,23,19,113,1472,34,1506,2312,65.2733345
6402700-006,永安區維新里,1215,420,146,141,49,29,175,2175,54,2229,3164,70.68500137
6402700-004,永安區鹽田里,145,34,11,17,7,1,18,233,6,239,369,64.76999664
6402200-005,田寮區七星里,299,75,14,3,0,5,30,426,14,440,630,69.83999634
6402200-008,田寮區三和里,122,57,24,9,1,4,22,239,10,249,393,63.36000061
6402200-003,田寮區大同里,178,38,12,3,1,1,25,258,13,271,374,72.45999908
6402200-009,田寮區古亭里,198,64,19,8,1,3,37,330,15,345,533,64.73000336
6402200-004,田寮區田寮里,142,45,7,6,2,5,20,227,7,234,358,65.36000061
6402200-007,田寮區西德里,288,106,35,23,9,11,45,517,21,538,820,65.61000061
6402200-002,田寮區南安里,419,124,39,22,12,9,88,713,31,744,1118,66.53000259
6402200-006,田寮區崇德里,329,140,51,35,7,15,78,655,32,687,934,73.55000305
6402200-001,田寮區鹿埔里,120,63,8,4,2,4,22,223,16,239,355,67.31999969
6402200-010,田寮區新興里,587,138,39,43,10,2,63,882,23,905,1229,73.59499741
6403300-004,甲仙區大田里,359,247,80,24,7,11,62,790,45,835,1535,54.40000153
6403300-007,甲仙區小林里,146,72,20,6,2,3,20,269,10,279,527,52.93999863
6403300-002,甲仙區西安里,204,246,57,12,10,16,44,589,15,604,892,67.70999908
6403300-003,甲仙區和安里,149,132,56,11,5,3,32,388,17,405,660,61.36000061
6403300-001,甲仙區東安里,111,87,11,8,9,3,25,254,5,259,480,53.95999908
6403300-006,甲仙區關山里,184,108,28,6,6,4,12,348,17,365,591,61.75999832
6403300-005,甲仙區寶隆里,232,101,22,13,5,6,29,408,13,421,694,60.65999985
6403400-005,杉林區上平里,395,237,50,21,16,31,78,828,45,873,1633,53.45999908
6403400-008,杉林區大愛里,507,272,78,30,16,9,82,994,36,1030,1903,54.13000107
6403400-006,杉林區月眉里,447,287,54,47,12,28,81,956,34,990,1681,58.88999939
6403400-007,杉林區月美里,418,148,32,14,7,12,61,692,32,724,1193,60.68999863
6403400-002,杉林區木梓里,203,98,24,7,5,2,43,382,16,398,696,57.18000031
6403400-001,杉林區杉林里,217,66,14,14,1,2,28,342,15,357,665,53.68000031
6403400-003,杉林區集來里,458,136,45,11,1,3,57,711,19,730,1341,52.42500114
6403400-004,杉林區新庄里,377,256,50,28,24,27,79,841,32,873,1568,56.46000099
6403800-003,那瑪夏區南沙魯里,132,111,14,1,1,0,32,291,11,302,508,59.45000076
6403800-001,那瑪夏區達卡努瓦里,85,332,51,8,5,8,70,559,34,593,1222,49.44999886
6403800-002,那瑪夏區瑪雅里,39,188,32,1,1,6,57,324,9,333,570,58.41999817
6401900-015,岡山區三和里,387,63,36,27,8,7,58,586,20,606,855,70.87999725
6401900-029,岡山區大莊里,346,137,36,18,11,12,62,622,32,654,945,69.20999908
6401900-006,岡山區大遼里,677,111,32,53,13,10,78,974,18,992,1287,77.08000183
6401900-033,岡山區仁義里,97,705,101,47,16,282,93,1341,23,1364,1898,71.83000183
6401900-016,岡山區仁壽里,1104,585,132,145,51,84,224,2325,41,2366,3272,72.38333384
6401900-020,岡山區台上里,1860,675,224,247,68,96,291,3461,58,3519,5016,70.32749939
6401900-001,岡山區平安里,413,189,40,47,16,26,71,802,12,814,1197,68
6401900-025,岡山區本洲里,681,255,93,65,24,22,98,1238,34,1272,1673,76.04999924
6401900-022,岡山區白米里,665,217,106,50,27,29,109,1203,16,1219,1699,71.79999924
6401900-023,岡山區石潭里,749,219,52,58,16,40,108,1242,35,1277,1741,73.40499878
6401900-019,岡山區竹圍里,2180,925,230,277,91,143,329,4175,68,4243,6101,69.51749992
6401900-011,岡山區協和里,1106,564,146,159,54,85,215,2329,38,2367,3388,69.94333394
6401900-030,岡山區協榮里,583,445,100,64,33,79,116,1420,20,1440,2081,69.30500031
6401900-008,岡山區和平里,110,49,8,19,0,20,27,233,2,235,314,74.83999634
6401900-002,岡山區岡山里,1374,555,179,166,63,81,227,2645,42,2687,4163,64.45000076
6401900-007,岡山區忠孝里,288,969,138,54,29,263,169,1910,41,1951,2747,71.91000112
6401900-013,岡山區信義里,447,381,73,44,25,77,137,1184,11,1195,1747,68.41500092
6401900-009,岡山區前峰里,1026,434,125,84,34,62,149,1914,46,1960,2784,70.40999985
6401900-012,岡山區後協里,1534,962,231,214,90,171,267,3469,70,3539,5184,68.30249786
6401900-005,岡山區後紅里,1163,654,173,160,53,111,203,2517,49,2566,3785,67.74000041
6401900-031,岡山區為隨里,275,72,23,40,10,9,45,474,11,485,623,77.84999847
6401900-018,岡山區程香里,1263,694,154,167,66,128,191,2663,42,2705,3829,70.6299998
6401900-028,岡山區華崗里,833,91,44,59,9,12,70,1118,23,1141,1508,75.70999908
6401900-027,岡山區嘉峰里,740,226,55,53,11,14,101,1200,27,1227,1690,73.65500259
6401900-026,岡山區嘉興里,1484,331,132,146,46,50,168,2357,50,2407,3367,71.53666687
6401900-003,岡山區壽天里,997,534,138,160,59,86,205,2179,24,2203,3134,70.33999888
6401900-032,岡山區壽峰里,702,339,82,99,51,66,144,1483,24,1507,2210,68.45000076
6401900-017,岡山區碧紅里,1289,508,147,164,49,85,176,2418,38,2456,3601,68.19333394
6401900-024,岡山區福興里,405,165,34,28,9,23,60,724,17,741,1020,72.65000153
6401900-004,岡山區維仁里,364,127,35,35,14,26,60,661,12,673,1022,65.84999847
6401900-010,岡山區劉厝里,611,138,58,62,18,26,74,987,23,1010,1387,72.81999969
6401900-014,岡山區潭底里,374,63,29,37,11,9,42,565,16,581,747,77.77999878
6401900-021,岡山區灣裡里,665,237,79,82,19,18,113,1213,25,1238,1742,71.00500107
6401300-024,林園區中汕里,961,110,52,71,17,23,138,1372,36,1408,2249,62.60499954
6401300-017,林園區中芸里,732,158,33,69,14,8,138,1152,27,1179,1766,66.93500137
6401300-006,林園區中門里,857,270,62,70,13,26,156,1454,42,1496,2350,63.16500092
6401300-005,林園區中厝里,997,446,90,115,20,39,145,1852,54,1906,2812,67.78499985
6401300-023,林園區五福里,964,205,62,69,20,19,121,1460,34,1494,2446,61.06000137
6401300-020,林園區仁愛里,1095,328,85,141,34,39,170,1892,35,1927,2822,68.36999893
6401300-021,林園區文賢里,772,311,82,93,31,26,128,1443,20,1463,2253,65.11999893
6401300-013,林園區王公里,1253,429,149,158,58,53,239,2339,60,2399,3588,66.88333384
6401300-011,林園區北汕里,507,191,32,44,8,23,79,884,19,903,1580,57.04500008
6401300-019,林園區西汕里,304,55,17,22,6,3,35,442,27,469,735,63.81000137
6401300-009,林園區西溪里,1331,328,104,82,39,21,266,2171,58,2229,3281,67.8700002
6401300-018,林園區東汕里,340,81,18,33,10,23,48,553,15,568,905,62.75999832
6401300-001,林園區東林里,938,345,77,108,21,43,158,1690,30,1720,2678,64.38999748
6401300-012,林園區林內里,563,369,56,51,16,27,85,1167,38,1205,1869,64.35000229
6401300-014,林園區林家里,445,146,37,51,12,16,75,782,22,804,1255,64.05999756
6401300-002,林園區林園里,1051,432,105,125,58,43,210,2024,44,2068,3195,64.96333313
6401300-007,林園區頂厝里,1586,460,129,132,34,31,240,2612,60,2672,4174,64.35499954
6401300-008,林園區港埔里,707,158,32,63,17,12,116,1105,29,1134,1720,65.95500183
6401300-010,林園區港嘴里,652,138,55,77,19,13,120,1074,20,1094,1590,68.80999756
6401300-003,林園區溪州里,1430,457,119,132,49,41,217,2445,70,2515,3750,67.03666687
6401300-016,林園區鳳芸里,772,162,44,64,17,15,123,1197,17,1214,1755,69.20000076
6401300-022,林園區廣應里,1205,374,99,146,40,28,203,2095,46,2141,3241,66.09666443
6401300-004,林園區潭頭里,887,346,90,81,30,23,183,1640,40,1680,2621,63.96500015
6401300-015,林園區龔厝里,685,188,73,56,16,20,91,1129,37,1166,1753,66.81499863
6402300-002,阿蓮區中路里,900,186,47,64,21,20,114,1352,34,1386,1966,70.45999908
6402300-011,阿蓮區玉庫里,493,95,28,22,11,10,48,707,21,728,1015,71.72000122
6402300-001,阿蓮區石安里,528,104,44,45,16,17,69,823,27,850,1283,66.25
6402300-008,阿蓮區和蓮里,928,244,78,85,23,21,103,1482,40,1522,2225,68.27499771
6402300-006,阿蓮區阿蓮里,1758,621,152,205,56,49,243,3084,77,3161,4705,67.13999748
6402300-009,阿蓮區青旗里,525,198,61,41,11,28,79,943,33,976,1455,67.08000183
6402300-012,阿蓮區南蓮里,998,423,128,116,38,49,141,1893,50,1943,2859,67.86500168
6402300-003,阿蓮區峯山里,479,163,34,34,8,8,66,792,19,811,1191,68.08999634
6402300-005,阿蓮區崗山里,296,95,28,29,3,5,41,497,23,520,758,68.59999847
6402300-007,阿蓮區清蓮里,987,309,101,97,40,27,154,1715,53,1768,2614,67.7899971
6402300-010,阿蓮區復安里,619,225,56,51,11,16,77,1055,31,1086,1605,67.5399971
6402300-004,阿蓮區港後里,724,303,85,102,20,24,117,1375,54,1429,2044,69.6099968
6400700-001,前金區三川里,289,72,27,23,16,19,43,489,6,495,683,72.47000122
6400700-019,前金區文西里,318,138,29,41,17,34,57,634,10,644,899,71.63999939
6400700-020,前金區文東里,350,185,49,52,16,56,67,775,10,785,1176,66.75
6400700-004,前金區北金里,305,123,21,42,9,27,64,591,5,596,870,68.51000214
6400700-010,前金區民生里,232,112,17,29,19,28,78,515,4,519,815,63.68000031
6400700-005,前金區東金里,351,123,25,43,20,29,54,645,9,654,960,68.12999725
6400700-012,前金區林投里,309,106,35,23,8,20,42,543,7,550,1006,54.66999817
6400700-015,前金區社西里,285,157,30,41,26,40,66,645,6,651,1028,63.33000183
6400700-014,前金區社東里,433,258,58,58,31,78,96,1012,12,1024,1535,66.79999924
6400700-017,前金區長生里,450,264,54,79,40,75,137,1099,18,1117,1667,67.01000214
6400700-003,前金區長城里,546,146,44,44,17,32,74,903,17,920,1342,68.55000305
6400700-008,前金區長興里,338,163,43,44,11,25,87,711,9,720,1098,65.56999969
6400700-009,前金區青山里,467,218,50,83,33,71,94,1016,10,1026,1562,65.69000244
6400700-007,前金區後金里,232,125,26,28,12,27,46,496,6,502,733,68.48999786
6400700-002,前金區草江里,309,171,28,44,21,41,62,676,5,681,1019,66.83000183
6400700-013,前金區國民里,308,141,37,45,18,21,65,635,9,644,965,66.73999786
6400700-016,前金區博孝里,299,152,42,31,21,26,52,623,7,630,923,68.26000214
6400700-011,前金區復元里,294,142,33,47,17,49,68,650,6,656,979,67.01000214
6400700-006,前金區新生里,996,591,122,136,71,126,197,2239,24,2263,3404,66.47999954
6400700-018,前金區榮復里,379,159,34,33,15,48,67,735,10,745,1084,68.73000336
6400900-005,前鎮區仁愛里,548,143,52,31,22,12,62,870,25,895,1307,68.48000336
6400900-008,前鎮區平昌里,294,40,20,17,6,3,38,418,4,422,629,67.08999634
6400900-007,前鎮區平等里,702,184,63,97,35,31,113,1225,23,1248,2593,48.13000107
6400900-029,前鎮區民權里,1081,682,155,215,113,248,239,2733,22,2755,3883,71.18333181
6400900-045,前鎮區竹中里,1042,458,124,147,72,109,191,2143,30,2173,3201,67.92500305
6400900-040,前鎮區竹內里,1041,430,99,131,44,65,190,2000,27,2027,2973,68.34500122
6400900-043,前鎮區竹北里,709,301,59,99,34,61,140,1403,13,1416,2136,66.31499863
6400900-044,前鎮區竹西里,1324,664,146,162,80,161,282,2819,37,2856,4026,71.02666728
6400900-041,前鎮區竹東里,700,305,86,102,36,62,135,1426,17,1443,2167,66.58499908
6400900-042,前鎮區竹南里,1958,892,195,363,121,257,398,4184,54,4238,6358,66.80249977
6400900-028,前鎮區西山里,1028,547,99,152,77,195,208,2306,34,2340,3383,69.18000031
6400900-033,前鎮區西甲里,717,259,58,90,32,60,124,1340,13,1353,1973,68.58000183
6400900-032,前鎮區良和里,740,539,96,129,66,142,189,1901,22,1923,2764,69.54999924
6400900-038,前鎮區忠孝里,731,417,104,90,61,134,178,1715,29,1744,2613,66.72999954
6400900-024,前鎮區忠純里,668,1322,235,147,46,485,267,3170,55,3225,4796,67.24000041
6400900-025,前鎮區忠誠里,195,581,89,50,23,248,157,1343,22,1365,2075,65.75999832
6400900-003,前鎮區明正里,1903,583,145,239,74,65,256,3265,56,3321,4759,69.78000132
6400900-002,前鎮區明孝里,994,300,85,83,32,35,125,1654,23,1677,2522,65.20999908
6400900-004,前鎮區明義里,859,285,75,93,40,40,148,1540,30,1570,2156,72.75999832
6400900-012,前鎮區明道里,505,102,32,22,9,12,63,745,12,757,1107,68.37999725
6400900-009,前鎮區明禮里,650,127,46,61,12,7,85,988,25,1013,1470,68.91000366
6400900-010,前鎮區信義里,621,120,52,65,11,20,86,975,17,992,1396,71.05999756
6400900-011,前鎮區信德里,879,245,94,81,16,48,127,1490,37,1527,2210,69.22000122
6400900-015,前鎮區前鎮里,591,148,39,60,17,23,77,955,20,975,1353,72.05999756
6400900-030,前鎮區建隆里,356,194,38,57,18,36,66,765,6,771,1136,67.87000275
6400900-031,前鎮區振興里,667,322,70,93,54,103,136,1445,12,1457,2135,68.27499771
6400900-001,前鎮區草衙里,3365,1012,339,345,88,126,492,5767,118,5885,8869,66.37799835
6400900-034,前鎮區盛興里,776,407,97,111,54,116,133,1694,14,1708,2657,64.31500053
6400900-035,前鎮區盛豐里,922,421,102,101,66,113,180,1905,18,1923,2923,65.79000092
6400900-039,前鎮區復國里,1014,409,68,122,51,83,153,1900,36,1936,2716,71.27000046
6400900-059,前鎮區瑞文里,915,239,67,105,33,44,122,1525,24,1549,2330,66.47999954
6400900-054,前鎮區瑞北里,1162,342,96,96,46,67,166,1975,29,2004,2932,68.45499802
6400900-052,前鎮區瑞平里,1371,534,122,158,61,80,208,2534,36,2570,3535,72.88333384
6400900-046,前鎮區瑞竹里,571,190,49,73,33,26,111,1053,16,1069,1615,66.19000244
6400900-055,前鎮區瑞西里,1099,279,78,109,33,40,167,1805,38,1843,2610,70.68000031
6400900-051,前鎮區瑞和里,780,219,56,77,23,21,111,1287,26,1313,1857,70.68000031
6400900-061,前鎮區瑞昌里,1156,371,76,120,49,40,182,1994,37,2031,2970,68.40499878
6400900-050,前鎮區瑞東里,841,253,65,98,30,46,134,1467,22,1489,2185,68.09000015
6400900-047,前鎮區瑞南里,1688,627,118,173,53,85,248,2992,36,3028,4383,69.11000061
6400900-056,前鎮區瑞崗里,985,317,76,131,48,62,143,1762,29,1791,2521,71.26499939
6400900-049,前鎮區瑞祥里,1565,647,144,226,69,106,262,3019,49,3068,4465,68.68666585
6400900-060,前鎮區瑞華里,1457,631,127,216,109,124,241,2905,34,2939,4226,69.54000092
6400900-053,前鎮區瑞隆里,1291,414,136,145,51,79,212,2328,20,2348,3376,69.49000041
6400900-058,前鎮區瑞誠里,922,324,105,121,40,77,116,1705,19,1724,2572,66.97499847
6400900-057,前鎮區瑞興里,1038,303,61,119,40,45,131,1737,31,1768,2499,70.70999908
6400900-048,前鎮區瑞豐里,934,353,114,122,33,47,194,1797,32,1829,2635,69.50999832
6400900-006,前鎮區德昌里,585,260,55,82,27,60,90,1159,18,1177,1799,65.42499924
6400900-036,前鎮區興中里,938,442,100,135,42,97,183,1937,27,1964,3042,64.47500229
6400900-014,前鎮區興仁里,328,58,27,21,5,5,51,495,11,506,742,68.19000244
6400900-013,前鎮區興化里,345,80,19,30,6,7,30,517,13,530,701,75.61000061
6400900-021,前鎮區興邦里,859,490,122,155,57,93,208,1984,33,2017,3089,65.22999954
6400900-037,前鎮區興東里,1581,737,161,252,149,216,300,3396,51,3447,5013,68.81000264
6400900-022,前鎮區鎮中里,323,104,18,41,3,13,36,538,7,545,795,68.55000305
6400900-023,前鎮區鎮北里,411,176,39,41,16,15,81,779,18,797,1062,75.05000305
6400900-018,前鎮區鎮昌里,816,223,75,91,26,23,109,1363,32,1395,1960,71.22000122
6400900-016,前鎮區鎮東里,781,189,50,82,25,15,108,1250,23,1273,1762,72.31500244
6400900-019,前鎮區鎮海里,1383,561,136,185,65,85,249,2664,39,2703,3902,69.28999837
6400900-020,前鎮區鎮陽里,342,142,36,39,15,22,50,646,17,663,974,68.06999969
6400900-017,前鎮區鎮榮里,935,232,50,83,23,25,126,1474,26,1500,2146,69.65000153
6403100-011,美濃區中圳里,601,337,78,43,44,45,123,1271,39,1310,2005,65.25999832
6403100-004,美濃區中壇里,584,426,78,48,35,33,141,1345,54,1399,2078,67.31999969
6403100-002,美濃區合和里,602,435,111,66,27,63,136,1440,51,1491,2317,64.14999962
6403100-017,美濃區吉和里,383,214,57,25,23,42,105,849,32,881,1355,65.01999664
6403100-018,美濃區吉東里,593,270,61,27,22,18,117,1108,42,1150,1733,66.36500168
6403100-016,美濃區吉洋里,652,324,74,41,15,24,89,1219,54,1273,1890,67.34999847
6403100-012,美濃區東門里,386,185,39,33,13,23,77,756,33,789,1256,62.81999969
6403100-013,美濃區泰安里,391,287,64,31,18,54,86,931,28,959,1494,64.19000244
6403100-015,美濃區清水里,608,264,66,36,12,42,101,1129,40,1169,1747,67.07500076
6403100-007,美濃區獅山里,879,332,101,60,32,36,149,1589,79,1668,2437,68.02000046
6403100-003,美濃區祿興里,729,436,102,70,27,64,161,1589,54,1643,2486,66.09000015
6403100-001,美濃區福安里,829,426,96,68,64,52,157,1692,57,1749,2626,66.94000053
6403100-019,美濃區廣林里,527,210,55,25,23,23,100,963,39,1002,1515,65.84000015
6403100-009,美濃區廣德里,486,191,62,24,7,14,90,874,25,899,1355,66.34999847
6403100-005,美濃區德興里,382,329,75,21,26,45,115,993,37,1030,1496,68.84999847
6403100-010,美濃區興隆里,400,161,42,27,14,29,71,744,28,772,1194,64.66000366
6403100-006,美濃區龍山里,634,344,84,35,34,49,140,1320,75,1395,2118,65.86999893
6403100-008,美濃區龍肚里,503,292,68,28,13,33,88,1025,34,1059,1536,68.93999863
6403100-014,美濃區瀰濃里,637,372,71,48,37,57,126,1348,52,1400,2234,62.66500092
6400800-013,苓雅區人和里,590,255,59,74,31,46,105,1160,12,1172,1755,66.73999786
6400800-033,苓雅區中正里,787,423,89,129,80,116,157,1781,21,1802,2643,68.24500275
6400800-062,苓雅區五福里,1185,619,132,135,64,137,219,2491,26,2517,3684,68.32666779
6400800-041,苓雅區五權里,664,304,63,104,40,85,153,1413,28,1441,2007,71.81000137
6400800-014,苓雅區仁政里,352,207,48,74,13,53,87,834,5,839,1229,68.26999664
6400800-067,苓雅區文昌里,1351,540,140,152,71,91,232,2577,23,2600,3744,69.48333232
6400800-018,苓雅區日中里,707,309,60,92,50,50,120,1388,18,1406,2137,65.67499924
6400800-061,苓雅區正大里,1404,718,160,229,107,184,266,3068,48,3116,4846,64.78333155
6400800-066,苓雅區正仁里,803,421,86,119,50,84,139,1702,27,1729,2555,67.66500092
6400800-063,苓雅區正心里,1134,595,97,141,68,115,227,2377,26,2403,3547,67.74499893
6400800-059,苓雅區正文里,644,294,53,108,33,66,106,1304,10,1314,1941,67.56499863
6400800-060,苓雅區正言里,901,422,94,144,57,89,201,1908,31,1939,2961,65.47999954
6400800-065,苓雅區正義里,856,370,100,108,62,75,182,1753,16,1769,2432,72.71500015
6400800-064,苓雅區正道里,1272,624,138,169,83,135,245,2666,37,2703,4097,65.97000122
6400800-042,苓雅區民主里,1200,616,120,163,85,146,224,2554,30,2584,3776,68.36000061
6400800-058,苓雅區永康里,660,344,94,91,53,101,153,1496,28,1524,2198,69.34999847
6400800-012,苓雅區田西里,440,204,39,67,20,49,73,892,16,908,1292,70.27999878
6400800-026,苓雅區光華里,294,103,16,21,6,12,47,499,9,508,682,74.48999786
6400800-035,苓雅區同慶里,539,357,77,117,62,126,156,1434,14,1448,2155,66.85500336
6400800-037,苓雅區安祥里,636,375,84,104,65,109,152,1525,25,1550,2221,69.44999695
6400800-020,苓雅區和煦里,638,327,78,94,41,68,132,1378,21,1399,1973,71.11000061
6400800-034,苓雅區尚義里,429,260,48,63,31,52,98,981,13,994,1427,69.66000366
6400800-030,苓雅區林中里,924,447,71,119,67,97,219,1944,28,1972,2879,68.52999878
6400800-025,苓雅區林安里,413,288,63,53,24,72,104,1017,11,1028,1436,71.58999634
6400800-029,苓雅區林西里,519,230,49,57,23,38,109,1025,6,1031,1567,65.79000092
6400800-032,苓雅區林南里,789,497,108,118,85,134,212,1943,28,1971,2828,69.69499969
6400800-031,苓雅區林泉里,522,370,50,80,63,85,97,1267,13,1280,1788,71.58999634
6400800-024,苓雅區林圍里,591,406,67,118,75,96,171,1524,21,1545,2266,68.17499924
6400800-023,苓雅區林富里,556,289,53,79,45,78,128,1228,10,1238,1792,69.08000183
6400800-028,苓雅區林華里,1020,413,76,107,42,102,174,1934,14,1948,2752,70.76000214
6400800-044,苓雅區林貴里,531,278,52,78,46,71,112,1168,18,1186,1737,68.27999878
6400800-047,苓雅區林靖里,356,315,47,66,51,93,127,1055,18,1073,1531,70.08000183
6400800-045,苓雅區林榮里,1148,619,152,194,88,154,297,2652,29,2681,3917,68.44333394
6400800-043,苓雅區林德里,517,301,48,63,39,80,154,1202,16,1218,1758,69.41999817
6400800-027,苓雅區林興里,527,162,41,54,32,24,64,904,15,919,1328,69.19999695
6400800-007,苓雅區城北里,444,211,44,69,24,41,81,914,14,928,1427,65.02999878
6400800-008,苓雅區城西里,248,104,24,32,12,21,50,491,5,496,768,64.58000183
6400800-009,苓雅區城東里,577,216,54,83,42,51,130,1153,10,1163,1876,62.38500214
6400800-038,苓雅區奏捷里,458,313,39,50,32,44,104,1040,21,1061,1502,70.63999939
6400800-068,苓雅區建軍里,737,274,85,96,27,58,125,1402,16,1418,1951,72.68000031
6400800-016,苓雅區美田里,358,187,45,46,30,48,81,795,13,808,1148,70.37999725
6400800-004,苓雅區苓中里,596,212,46,64,23,46,94,1081,18,1099,1590,69.12000275
6400800-003,苓雅區苓昇里,429,160,48,42,22,49,79,829,18,847,1211,69.94000244
6400800-006,苓雅區苓東里,523,183,40,46,19,40,72,923,19,942,1467,64.20999908
6400800-002,苓雅區苓洲里,447,229,50,52,24,57,103,962,19,981,1458,67.27999878
6400800-005,苓雅區苓雅里,442,257,50,70,27,73,98,1017,19,1036,1444,71.75
6400800-046,苓雅區英明里,704,260,65,67,36,58,122,1312,12,1324,1908,69.40000153
6400800-036,苓雅區凱旋里,520,409,82,99,36,104,145,1395,14,1409,2029,69.44000244
6400800-001,苓雅區博仁里,205,134,39,22,19,21,47,487,8,495,693,71.43000031
6400800-022,苓雅區普天里,932,456,106,144,87,118,220,2063,29,2092,3049,68.58499908
6400800-019,苓雅區普照里,935,438,103,121,50,104,208,1959,25,1984,2915,68.15999985
6400800-021,苓雅區晴朗里,395,189,34,46,25,40,73,802,15,817,2039,40.06999969
6400800-048,苓雅區朝陽里,508,210,47,74,23,51,87,1000,11,1011,1448,69.81999969
6400800-017,苓雅區華堂里,1005,424,101,125,62,106,169,1992,24,2016,2994,67.34000015
6400800-010,苓雅區意誠里,937,505,147,113,54,127,202,2085,24,2109,3499,60.64500046
6400800-011,苓雅區鼓中里,355,162,37,39,18,30,60,701,12,713,970,73.51000214
6400800-053,苓雅區福人里,696,334,51,85,31,62,127,1386,29,1415,2040,69.27000046
6400800-054,苓雅區福地里,912,416,101,101,60,80,140,1810,30,1840,2693,68.34500122
6400800-057,苓雅區福西里,680,230,71,62,36,32,95,1206,22,1228,1770,69.40499878
6400800-055,苓雅區福居里,1017,392,109,115,35,30,148,1846,24,1870,2652,70.51000214
6400800-056,苓雅區福東里,866,359,88,108,56,90,195,1762,21,1783,2550,70.15499878
6400800-040,苓雅區福南里,718,241,57,73,19,34,110,1252,22,1274,1765,72.19499969
6400800-051,苓雅區福海里,315,215,38,37,23,29,55,712,9,721,1040,69.33000183
6400800-052,苓雅區福康里,739,254,58,66,34,34,130,1315,19,1334,1861,71.68500137
6400800-050,苓雅區福祥里,406,214,38,49,17,34,65,823,14,837,1202,69.62999725
6400800-049,苓雅區福隆里,928,371,98,118,46,75,148,1784,25,1809,2510,72.11499786
6400800-039,苓雅區福壽里,630,184,44,64,22,21,83,1048,22,1070,1463,73.13999939
6400800-015,苓雅區廣澤里,678,263,51,82,32,54,88,1248,16,1264,1779,71.03499985
6400800-069,苓雅區衛武里,592,353,86,67,47,67,128,1340,11,1351,2010,67.22000122
6403600-003,茂林區多納里,18,200,13,0,2,2,24,259,8,267,457,58.41999817
6403600-001,茂林區茂林里,57,257,27,7,4,8,51,411,12,423,658,64.29000092
6403600-002,茂林區萬山里,25,138,16,2,0,2,20,203,10,213,332,64.16000366
6402600-009,茄萣區大定里,365,145,87,40,14,11,44,706,27,733,1136,64.51999664
6402600-003,茄萣區白雲里,567,233,76,70,14,14,80,1054,26,1080,1665,64.86000061
6402600-008,茄萣區光定里,322,109,48,30,13,10,55,587,22,609,986,61.75999832
6402600-010,茄萣區吉定里,487,91,51,35,17,10,61,752,24,776,1135,68.37000275
6402600-014,茄萣區和協里,399,121,25,44,8,14,49,660,18,678,1094,61.97000122
6402600-007,茄萣區保定里,1044,279,126,135,41,43,163,1831,58,1889,2904,64.94000053
6402600-015,茄萣區崎漏里,1502,475,229,135,41,45,186,2613,46,2659,4277,62.22000122
6402600-002,茄萣區萬福里,304,100,37,26,4,28,47,546,17,563,877,64.19999695
6402600-005,茄萣區嘉安里,559,183,75,89,21,17,82,1026,30,1056,1689,62.52000046
6402600-006,茄萣區嘉定里,438,132,33,36,9,21,39,708,9,717,1147,62.50999832
6402600-012,茄萣區嘉泰里,425,109,42,40,18,16,59,709,19,728,1137,64.02999878
6402600-013,茄萣區嘉福里,335,115,34,40,4,5,42,575,18,593,986,60.13999939
6402600-011,茄萣區嘉樂里,670,252,85,72,20,16,100,1215,33,1248,1873,66.59000015
6402600-004,茄萣區嘉賜里,1296,393,149,181,52,57,156,2284,48,2332,3552,65.48500061
6402600-001,茄萣區福德里,435,101,41,33,14,10,58,692,15,707,960,73.65000153
6403700-007,桃源區拉芙蘭里,33,35,4,3,1,2,38,116,10,126,225,56
6403700-003,桃源區建山里,38,130,40,8,4,4,45,269,22,291,580,50.16999817
6403700-001,桃源區桃源里,52,191,29,13,7,2,73,367,14,381,726,52.47999954
6403700-004,桃源區高中里,43,130,22,4,1,3,71,274,8,282,573,49.20999908
6403700-008,桃源區梅山里,19,61,15,4,0,6,24,129,9,138,252,54.75999832
6403700-006,桃源區復興里,11,58,5,5,1,13,30,123,5,128,263,48.66999817
6403700-005,桃源區勤和里,13,47,14,6,2,3,30,115,5,120,212,56.59999847
6403700-002,桃源區寶山里,32,120,10,6,4,4,32,208,12,220,430,51.15999985
6402900-011,梓官區大舍里,1417,418,99,131,46,42,219,2372,56,2428,3488,69.58333333
6402900-005,梓官區中崙里,476,148,35,32,14,6,62,773,11,784,1101,71.20999908
6402900-010,梓官區同安里,445,109,19,29,11,11,69,693,15,708,952,74.37000275
6402900-013,梓官區赤西里,270,125,30,27,11,13,38,514,10,524,785,66.75
6402900-012,梓官區赤東里,932,264,56,93,26,15,118,1504,38,1542,2218,69.30500031
6402900-006,梓官區赤崁里,797,236,57,55,7,17,127,1296,29,1325,1819,73.07500076
6402900-015,梓官區典寶里,1091,368,90,102,26,52,157,1886,34,1920,2780,69.52000046
6402900-009,梓官區信蚵里,851,276,100,90,23,28,165,1533,25,1558,2227,69.125
6402900-014,梓官區茄苳里,853,326,82,67,19,28,152,1527,35,1562,2276,68.59000015
6402900-004,梓官區梓平里,593,152,45,58,28,14,87,977,22,999,1366,73.12999725
6402900-003,梓官區梓和里,910,295,56,84,36,36,137,1554,36,1590,2236,70.93333435
6402900-001,梓官區梓信里,899,209,65,84,21,25,158,1461,26,1487,2078,71.56000137
6402900-002,梓官區梓義里,781,249,56,78,38,18,105,1325,26,1351,1955,69.15499878
6402900-008,梓官區智蚵里,1054,349,119,108,30,37,198,1895,36,1931,2778,69.40499878
6402900-007,梓官區禮蚵里,898,221,59,68,17,31,182,1476,32,1508,2107,71.57499695
6401800-006,鳥松區大竹里,291,65,15,28,8,19,25,451,8,459,640,71.72000122
6401800-003,鳥松區大華里,2966,1481,286,432,250,420,573,6408,66,6474,9202,70.38166809
6401800-005,鳥松區仁美里,2434,749,183,235,70,90,335,4096,72,4168,6150,67.85000076
6401800-004,鳥松區坔埔里,1423,364,99,141,61,63,220,2371,36,2407,3409,70.60666656
6401800-001,鳥松區鳥松里,3151,1340,282,411,215,250,543,6192,69,6261,9634,64.79571533
6401800-007,鳥松區華美里,1360,600,142,168,56,62,242,2630,38,2668,3818,69.8700002
6401800-002,鳥松區夢裡里,1382,619,135,205,97,132,271,2841,29,2870,4294,67.9766655
6402500-006,湖內區大湖里,1164,508,127,145,34,70,191,2239,53,2292,3427,66.81999969
6402500-011,湖內區中賢里,750,221,70,77,17,18,117,1270,21,1291,2088,61.47000122
6402500-004,湖內區公舘里,703,283,77,107,39,20,114,1343,23,1366,2047,66.73000336
6402500-003,湖內區太爺里,318,105,22,28,24,9,44,550,15,565,800,70.62999725
6402500-010,湖內區文賢里,486,124,30,35,17,18,65,775,19,794,1130,70.26999664
6402500-007,湖內區田尾里,353,181,38,49,14,8,67,710,21,731,1013,72.16000366
6402500-013,湖內區忠興里,281,111,28,35,6,10,32,503,11,514,680,75.58999634
6402500-001,湖內區海山里,452,144,40,36,16,23,38,749,21,770,1108,69.48999786
6402500-009,湖內區海埔里,770,175,57,64,14,15,97,1192,23,1215,1820,67.34000015
6402500-008,湖內區湖內里,1252,495,134,149,48,71,159,2308,57,2365,3430,69.06749916
6402500-014,湖內區湖東里,718,407,120,90,24,51,119,1529,41,1570,2500,62.98999977
6402500-012,湖內區逸賢里,430,114,33,48,14,10,54,703,18,721,1074,67.12999725
6402500-005,湖內區葉厝里,1020,240,74,118,32,26,116,1626,24,1650,2409,68.68500137
6402500-002,湖內區劉家里,425,99,27,36,9,12,51,659,20,679,995,68.23999786
6400600-025,新興區大明里,371,153,31,50,21,17,71,714,15,729,1074,67.87999725
6400600-023,新興區中東里,691,351,103,101,50,88,143,1527,21,1548,2701,57.11999893
6400600-007,新興區仁聲里,291,141,38,43,19,24,43,599,12,611,987,61.90000153
6400600-014,新興區文昌里,714,410,71,136,57,95,181,1664,15,1679,2449,68.47000122
6400600-005,新興區正氣里,438,250,49,44,36,51,79,947,17,964,1393,69.19999695
6400600-011,新興區永寧里,397,222,54,69,36,31,82,891,15,906,1352,67.01000214
6400600-012,新興區玉衡里,287,111,27,34,20,20,55,554,12,566,839,67.45999908
6400600-015,新興區光耀里,664,398,71,112,70,76,137,1528,15,1543,2234,69.08499908
6400600-018,新興區成功里,316,207,42,45,25,50,66,751,7,758,1122,67.55999756
6400600-024,新興區明莊里,253,89,20,34,8,15,38,457,15,472,699,67.52999878
6400600-032,新興區東坡里,457,167,49,49,19,26,68,835,19,854,1217,70.16999817
6400600-027,新興區長驛里,305,116,30,32,23,23,58,587,11,598,927,64.51000214
6400600-022,新興區南港里,766,268,67,84,35,44,111,1375,18,1393,1895,73.56499863
6400600-029,新興區建華里,310,103,21,30,15,25,48,552,4,556,832,66.83000183
6400600-028,新興區建興里,317,125,24,49,8,20,64,607,8,615,923,66.62999725
6400600-026,新興區秋山里,281,87,28,34,10,16,52,508,8,516,816,63.24000168
6400600-002,新興區振成里,313,164,31,43,16,43,85,695,5,700,1093,64.04000092
6400600-004,新興區振華里,332,194,33,53,20,44,61,737,8,745,1104,67.48000336
6400600-001,新興區浩然里,515,334,66,79,30,82,100,1206,15,1221,1771,68.90999985
6400600-009,新興區華聲里,329,140,26,43,19,35,66,658,4,662,962,68.80999756
6400600-017,新興區開平里,1045,563,68,153,72,138,175,2214,19,2233,3227,69.17000198
6400600-013,新興區順昌里,640,290,67,71,40,44,100,1252,19,1271,1803,70.42000198
6400600-021,新興區愛平里,297,139,28,37,16,30,70,617,10,627,971,64.56999969
6400600-019,新興區新江里,383,150,27,68,19,26,61,734,10,744,1107,67.20999908
6400600-031,新興區榮治里,234,111,27,28,20,16,56,492,7,499,742,67.25
6400600-030,新興區漢民里,279,93,22,32,13,16,59,514,11,525,710,73.94000244
6400600-003,新興區德生里,774,437,124,146,71,131,211,1894,21,1915,2867,66.85000229
6400600-006,新興區德政里,210,119,30,38,11,25,45,478,11,489,684,71.48999786
6400600-008,新興區德望里,578,303,59,69,47,72,138,1266,20,1286,1943,66.23999786
6400600-020,新興區黎明里,295,101,33,43,9,23,50,554,5,559,836,66.87000275
6400600-016,新興區興昌里,563,300,52,86,24,45,135,1205,14,1219,1800,67.68999863
6400600-010,新興區蕉園里,264,136,17,32,8,27,54,538,8,546,733,74.48999786
6400400-019,楠梓區久昌里,710,448,103,88,35,65,135,1584,27,1611,2465,65.33500099
6400400-020,楠梓區大昌里,615,410,58,62,25,50,141,1361,22,1383,2050,67.47000122
6400400-037,楠梓區中和里,762,219,48,88,26,30,126,1299,26,1325,1892,70.02999878
6400400-005,楠梓區中陽里,1138,295,84,111,41,35,151,1855,25,1880,2627,71.57500076
6400400-036,楠梓區中興里,590,171,35,67,28,33,108,1032,12,1044,1421,73.47000122
6400400-003,楠梓區五常里,1885,676,190,260,70,69,302,3452,49,3501,5345,65.34000015
6400400-034,楠梓區仁昌里,1167,855,167,179,56,124,248,2796,33,2829,4504,62.89666494
6400400-033,楠梓區加昌里,1953,1516,314,292,125,293,435,4928,60,4988,7659,65.15400162
6400400-010,楠梓區玉屏里,1168,171,45,86,58,23,120,1671,23,1694,2279,74.38999939
6400400-026,楠梓區宏昌里,826,542,114,110,36,112,174,1914,29,1943,2844,68.30499649
6400400-015,楠梓區宏南里,249,331,29,50,36,115,88,898,15,913,1252,72.91999817
6400400-017,楠梓區宏榮里,676,654,106,96,47,88,230,1897,38,1935,2911,67.41999817
6400400-016,楠梓區宏毅里,921,451,65,85,48,64,142,1776,27,1803,2496,72.19499969
6400400-030,楠梓區秀昌里,555,401,66,80,39,93,119,1353,25,1378,2020,68.10499954
6400400-004,楠梓區享平里,1023,361,84,142,57,67,160,1894,28,1922,2868,67.12000084
6400400-027,楠梓區和昌里,612,385,65,69,35,93,134,1393,19,1412,2015,70.09000015
6400400-002,楠梓區東寧里,1159,641,170,175,74,97,256,2572,29,2601,4046,64.34499931
6400400-011,楠梓區金田里,1403,310,67,146,62,33,194,2215,41,2256,3150,71.63000107
6400400-025,楠梓區建昌里,798,638,117,97,59,99,236,2044,38,2082,3181,65.88499832
6400400-023,楠梓區泰昌里,477,248,36,41,17,32,66,917,24,941,1397,67.36000061
6400400-032,楠梓區國昌里,1029,536,99,133,57,95,205,2154,31,2185,3209,68.08000183
6400400-001,楠梓區清豐里,6421,2476,584,885,314,393,1038,12111,166,12277,18223,67.43636461
6400400-022,楠梓區盛昌里,1417,981,137,211,89,185,302,3322,37,3359,4982,67.44333394
6400400-007,楠梓區惠民里,1288,562,147,143,74,83,232,2529,37,2566,3646,70.33000183
6400400-006,楠梓區惠楠里,873,385,80,109,33,51,148,1679,28,1707,2963,58.36499977
6400400-008,楠梓區惠豐里,1242,725,169,180,62,171,319,2868,38,2906,4323,67.31999969
6400400-029,楠梓區隆昌里,940,647,103,131,59,115,222,2217,22,2239,3296,67.93000031
6400400-013,楠梓區瑞屏里,1307,519,123,166,52,86,207,2460,32,2492,3676,67.69999695
6400400-012,楠梓區稔田里,769,85,34,56,21,21,95,1081,12,1093,1520,71.91000366
6400400-031,楠梓區裕昌里,1338,597,89,148,69,109,251,2601,40,2641,3847,68.66500092
6400400-021,楠梓區福昌里,726,328,52,66,31,56,120,1379,8,1387,1941,71.58499908
6400400-014,楠梓區翠屏里,3483,2494,515,537,238,565,870,8702,99,8801,13848,63.59499979
6400400-018,楠梓區廣昌里,966,585,86,101,50,103,178,2069,35,2104,2902,72.66999817
6400400-028,楠梓區慶昌里,869,639,84,131,81,154,215,2173,21,2194,3081,71.19999695
6400400-024,楠梓區興昌里,1250,664,120,176,85,103,268,2666,42,2708,3982,67.92499924
6400400-009,楠梓區錦屏里,1479,343,78,136,61,43,170,2310,32,2342,3250,72.07999802
6400400-035,楠梓區藍田里,1474,830,155,251,90,154,334,3288,30,3318,4804,68.8833313
6402400-015,路竹區三爺里,357,107,33,35,14,6,50,602,20,622,855,72.75
6402400-009,路竹區下坑里,933,349,136,88,36,19,189,1750,54,1804,2617,68.94999949
6402400-013,路竹區文北里,1074,382,134,125,37,31,165,1948,37,1985,2972,66.78999837
6402400-014,路竹區文南里,819,398,86,121,32,22,145,1623,30,1653,2298,72.23500061
6402400-005,路竹區北嶺里,520,213,36,59,9,17,56,910,23,933,1248,74.76000214
6402400-007,路竹區甲北里,722,287,83,61,26,19,89,1287,47,1334,2032,65.80999947
6402400-008,路竹區甲南里,909,556,106,136,44,33,228,2012,92,2104,3138,66.99333191
6402400-012,路竹區竹西里,724,385,79,89,34,31,126,1468,45,1513,2196,68.84500122
6402400-011,路竹區竹東里,1108,605,105,159,43,37,167,2224,32,2256,3243,69.56999969
6402400-019,路竹區竹南里,890,447,110,100,31,49,157,1784,28,1812,2656,68.19333394
6402400-010,路竹區竹園里,632,194,41,71,25,10,108,1081,46,1127,1774,63.28000069
6402400-001,路竹區竹滬里,1091,377,112,123,42,25,154,1924,44,1968,3011,65.38000107
6402400-018,路竹區社中里,276,140,38,33,9,7,55,558,15,573,865,66.23999786
6402400-006,路竹區社西里,787,331,83,82,32,21,102,1438,37,1475,2197,67.14500046
6402400-017,路竹區社東里,652,248,54,79,29,12,94,1168,33,1201,1685,71.23500061
6402400-020,路竹區社南里,1464,624,144,191,50,59,254,2786,63,2849,4177,68.14749908
6402400-004,路竹區後鄉里,441,182,33,31,9,4,49,749,20,769,1036,74.23000336
6402400-002,路竹區頂寮里,453,173,25,37,12,10,69,779,24,803,1159,69.27999878
6402400-003,路竹區新達里,409,160,43,63,19,16,69,779,48,827,1206,68.56999969
6402400-016,路竹區鴨寮里,693,289,73,74,31,22,97,1279,33,1312,1860,70.47499847
6400200-026,鼓山區山下里,406,246,55,52,20,36,85,900,16,916,1305,70.19000244
6400200-006,鼓山區內惟里,429,169,34,54,14,17,65,782,20,802,1105,72.58000183
6400200-012,鼓山區平和里,1382,473,104,140,68,85,176,2428,37,2465,3399,72.55000305
6400200-011,鼓山區正德里,757,276,54,62,26,43,124,1342,25,1367,1918,71.26999664
6400200-013,鼓山區民強里,1078,395,79,124,28,64,185,1953,35,1988,2644,75.22999954
6400200-005,鼓山區民族里,502,242,25,52,16,25,77,939,19,958,1276,75.08000183
6400200-025,鼓山區光化里,427,220,39,43,14,31,79,853,15,868,1262,68.77999878
6400200-004,鼓山區光榮里,1427,430,83,162,55,62,221,2440,24,2464,3417,72.04666646
6400200-009,鼓山區自強里,26,270,40,13,17,115,50,531,7,538,734,73.30000305
6400200-033,鼓山區延平里,318,87,21,39,7,18,54,544,7,551,767,71.83999634
6400200-008,鼓山區忠正里,1282,624,106,154,58,98,246,2568,39,2607,3695,70.53666687
6400200-017,鼓山區明誠里,3802,2485,553,597,323,665,958,9383,92,9475,14818,63.96624899
6400200-027,鼓山區河邊里,540,283,53,77,20,36,90,1099,16,1115,1615,69.04000092
6400200-003,鼓山區前峰里,1173,878,136,175,71,225,329,2987,50,3037,4175,72.66666667
6400200-014,鼓山區厚生里,1182,414,88,127,43,49,204,2107,33,2140,3034,70.42499924
6400200-007,鼓山區建國里,833,372,52,83,46,70,162,1618,26,1644,2256,72.54000092
6400200-037,鼓山區哨船頭里,304,163,37,40,14,26,61,645,11,656,979,67.01000214
6400200-030,鼓山區峰南里,319,127,15,29,8,19,48,565,16,581,861,67.48000336
6400200-038,鼓山區桃源里,199,80,16,34,6,8,33,376,17,393,609,64.52999878
6400200-035,鼓山區惠安里,449,117,38,44,11,21,80,760,17,777,1172,66.30000305
6400200-029,鼓山區登山里,225,101,20,19,7,9,36,417,9,426,628,67.83000183
6400200-018,鼓山區華豐里,970,683,148,143,107,248,242,2541,28,2569,3702,69.38999939
6400200-002,鼓山區雄峰里,379,454,95,56,44,148,130,1306,20,1326,1988,66.57500076
6400200-032,鼓山區新民里,407,99,43,44,9,20,57,679,17,696,1012,68.76999664
6400200-019,鼓山區裕興里,848,667,123,124,91,202,197,2252,36,2288,3410,66.95500183
6400200-020,鼓山區裕豐里,565,597,96,107,58,166,160,1749,15,1764,2541,69.42000198
6400200-021,鼓山區鼓岩里,456,170,40,41,14,12,81,814,22,836,1259,66.40000153
6400200-001,鼓山區鼓峰里,497,377,92,76,31,110,123,1306,17,1323,1917,68.97999954
6400200-036,鼓山區壽山里,545,136,47,59,9,13,76,885,19,904,1352,66.86000061
6400200-028,鼓山區綠川里,574,188,39,51,22,21,90,985,20,1005,1434,70.08000183
6400200-034,鼓山區維生里,482,122,58,66,12,24,76,840,9,849,1259,67.43000031
6400200-022,鼓山區樹德里,484,151,24,56,9,23,78,825,11,836,1121,74.58000183
6400200-024,鼓山區興宗里,455,208,62,40,11,30,67,873,15,888,1304,68.09999847
6400200-015,鼓山區龍子里,3927,1940,459,704,333,463,838,8664,96,8760,13393,65.475714
6400200-010,鼓山區龍井里,428,183,43,33,23,49,76,835,17,852,1265,67.34999847
6400200-016,鼓山區龍水里,4627,2612,589,904,499,797,1192,11220,95,11315,17293,65.43333308
6400200-031,鼓山區麗興里,374,120,30,38,8,18,64,652,14,666,956,69.66999817
6400200-023,鼓山區寶樹里,461,147,52,50,14,19,61,804,12,816,1774,46
6403000-016,旗山區三協里,651,262,113,56,29,46,168,1325,62,1387,2082,66.23999786
6403000-007,旗山區上洲里,429,99,26,24,14,22,73,687,19,706,993,71.09999847
6403000-018,旗山區大山里,512,139,43,36,17,8,79,834,33,867,1258,68.91999817
6403000-006,旗山區大林里,453,203,45,32,15,17,76,841,33,874,1393,62.55999947
6403000-002,旗山區大德里,735,407,80,100,38,57,156,1573,23,1596,2337,68.15499878
6403000-005,旗山區中正里,418,265,71,28,21,17,89,909,33,942,1474,63.2349987
6403000-019,旗山區中洲里,359,91,33,22,10,7,53,575,26,601,865,69.48000336
6403000-010,旗山區中寮里,58,18,8,11,0,1,12,108,13,121,182,66.48000336
6403000-001,旗山區太平里,710,329,98,82,27,32,159,1437,38,1475,2204,66.97000122
6403000-015,旗山區永和里,1117,413,127,101,46,52,191,2047,66,2113,3234,65.32333374
6403000-013,旗山區竹峰里,498,234,54,42,21,38,107,994,22,1016,1516,66.52499962
6403000-011,旗山區東平里,653,275,70,46,47,37,136,1264,37,1301,1918,67.79999924
6403000-012,旗山區東昌里,294,190,30,26,13,23,68,644,17,661,1027,64.36000061
6403000-020,旗山區南洲里,528,191,56,47,13,29,70,934,27,961,1335,71.98999786
6403000-009,旗山區南勝里,924,282,59,48,23,24,121,1481,51,1532,2181,70.28499985
6403000-003,旗山區湄洲里,528,269,75,42,18,24,106,1062,25,1087,1702,63.77499962
6403000-004,旗山區圓富里,536,219,58,47,25,20,108,1013,38,1051,1768,59.51000023
6403000-008,旗山區新光里,312,140,32,18,4,9,45,560,9,569,808,70.41999817
6403000-014,旗山區瑞吉里,704,260,77,64,23,42,143,1313,33,1346,1947,69.10500336
6403000-021,旗山區廣福里,157,106,27,13,17,21,37,378,15,393,602,65.27999878
6403000-017,旗山區鯤洲里,365,69,21,21,16,6,69,567,13,580,784,73.98000336
6401000-010,旗津區上竹里,1158,208,68,107,26,26,137,1730,42,1772,2696,66.02000046
6401000-011,旗津區中洲里,749,137,58,64,18,38,90,1154,20,1174,1776,66.09999847
6401000-006,旗津區中華里,586,134,56,54,21,25,87,963,23,986,1431,68.90000153
6401000-013,旗津區中興里,1047,241,72,100,27,37,166,1690,40,1730,2485,69.68499756
6401000-008,旗津區北汕里,899,264,112,85,15,21,134,1530,26,1556,2544,61.07499886
6401000-002,旗津區永安里,392,115,31,33,4,18,77,670,20,690,1093,63.13000107
6401000-012,旗津區安順里,343,74,17,32,6,7,43,522,13,535,869,61.56999969
6401000-009,旗津區南汕里,787,165,64,56,31,20,99,1222,18,1240,1953,63.49000168
6401000-003,旗津區振興里,621,170,50,56,22,18,81,1018,25,1043,1593,65.47000122
6401000-005,旗津區復興里,921,359,92,92,27,61,167,1719,49,1768,2848,62.16999817
6401000-004,旗津區慈愛里,840,214,70,76,27,18,103,1348,33,1381,2236,61.68999863
6401000-007,旗津區實踐里,263,294,54,28,11,58,74,782,23,805,1327,60.65999985
6401000-001,旗津區旗下里,460,126,30,36,19,18,59,748,15,763,1159,65.83000183
6401200-028,鳳山區一甲里,1226,358,94,111,35,72,173,2069,34,2103,3131,67.27999878
6401200-072,鳳山區二甲里,1643,601,140,198,61,79,297,3019,35,3054,4422,69.12666575
6401200-051,鳳山區三民里,301,188,36,51,15,28,77,696,14,710,1009,70.37000275
6401200-057,鳳山區大德里,1617,496,146,188,49,71,215,2782,51,2833,4111,68.90666707
6401200-015,鳳山區中正里,365,1527,189,92,27,259,179,2638,46,2684,3830,70.13666789
6401200-071,鳳山區中民里,1491,488,187,190,45,89,257,2747,35,2782,4212,66.09333293
6401200-008,鳳山區中和里,909,652,112,162,82,154,209,2280,35,2315,3323,69.65666453
6401200-069,鳳山區中崙里,793,372,112,106,31,55,151,1620,25,1645,2450,67.15499878
6401200-070,鳳山區中榮里,1525,556,191,163,47,87,213,2782,42,2824,4302,65.75
6401200-043,鳳山區五福里,1098,420,96,138,49,48,198,2047,31,2078,2959,70.19999949
6401200-032,鳳山區天興里,1309,413,90,132,61,76,163,2244,28,2272,3341,67.99000041
6401200-048,鳳山區文山里,2163,730,162,244,128,129,327,3883,68,3951,5863,67.34799957
6401200-011,鳳山區文英里,1073,455,110,146,62,90,205,2141,30,2171,3176,68.56999969
6401200-056,鳳山區文華里,2111,1587,289,320,159,309,457,5232,72,5304,7943,67.05500031
6401200-060,鳳山區文福里,2431,1354,387,415,190,306,556,5639,66,5705,8541,66.75666682
6401200-039,鳳山區文德里,2202,1275,310,438,195,347,483,5250,53,5303,7987,66.42600098
6401200-059,鳳山區文衡里,1156,602,129,174,91,98,241,2491,39,2530,3854,65.65999858
6401200-053,鳳山區北門里,1351,568,155,179,51,111,227,2642,53,2695,4017,67.49750137
6401200-027,鳳山區正義里,2384,670,232,273,73,112,358,4102,45,4147,5957,69.65800018
6401200-045,鳳山區生明里,475,444,82,70,43,113,94,1321,27,1348,1956,68.91999817
6401200-003,鳳山區光明里,443,209,34,50,29,38,82,885,22,907,1324,68.5
6401200-002,鳳山區成功里,229,110,23,37,12,16,48,475,8,483,702,68.80000305
6401200-017,鳳山區老爺里,2531,770,202,288,83,109,340,4323,67,4390,6524,67.18200073
6401200-047,鳳山區協和里,933,652,146,164,79,136,225,2335,29,2364,3411,69.43000031
6401200-006,鳳山區和德里,585,302,81,104,36,79,95,1282,21,1303,1904,68.43999863
6401200-046,鳳山區和興里,1522,753,173,216,70,156,314,3204,48,3252,4739,68.62999916
6401200-044,鳳山區忠孝里,1676,971,210,269,83,175,314,3698,48,3746,5530,67.76199951
6401200-019,鳳山區忠義里,1296,707,155,204,96,166,300,2924,26,2950,4344,67.62250137
6401200-024,鳳山區忠誠里,1158,407,111,150,62,61,199,2148,26,2174,3134,69.42499924
6401200-030,鳳山區東門里,1301,1084,216,188,72,296,236,3393,52,3445,5279,65.4024992
6401200-058,鳳山區武松里,925,365,86,126,44,76,133,1755,23,1778,2669,66.35500145
6401200-026,鳳山區武漢里,1605,602,154,212,82,117,262,3034,29,3063,4514,68.01750183
6401200-064,鳳山區武慶里,845,306,62,97,39,52,129,1530,14,1544,2280,67.78000259
6401200-078,鳳山區保安里,1986,705,175,270,87,122,314,3659,29,3688,5268,70.10666656
6401200-055,鳳山區南成里,2802,843,217,350,121,127,359,4819,94,4913,7038,69.94999949
6401200-076,鳳山區南和里,985,343,88,118,36,40,160,1770,32,1802,2572,70.02500153
6401200-005,鳳山區南興里,291,154,34,53,18,23,44,617,7,624,914,68.26999664
6401200-022,鳳山區海光里,689,621,140,107,42,139,171,1909,24,1933,2936,65.91499901
6401200-065,鳳山區海洋里,1269,531,136,183,78,106,220,2523,27,2550,3617,70.49333445
6401200-037,鳳山區國光里,1032,550,114,147,72,101,219,2235,28,2263,3378,66.98000081
6401200-034,鳳山區國泰里,1230,596,130,162,68,114,224,2524,30,2554,3780,67.55666606
6401200-063,鳳山區國富里,773,393,106,152,52,88,147,1711,18,1729,2474,69.81999969
6401200-038,鳳山區國隆里,927,301,72,102,39,36,144,1621,16,1637,2495,65.63000107
6401200-014,鳳山區埤頂里,1735,1179,203,225,84,217,290,3933,55,3988,5770,69.15250206
6401200-041,鳳山區曹公里,596,306,71,73,47,58,136,1287,21,1308,1983,65.81000137
6401200-075,鳳山區善美里,1768,648,187,224,91,99,247,3264,59,3323,5160,64.67499924
6401200-054,鳳山區富甲里,662,220,67,66,21,27,120,1183,35,1218,2424,50.77999878
6401200-074,鳳山區富榮里,800,354,89,108,48,42,143,1584,18,1602,2383,67.25500107
6401200-025,鳳山區新甲里,1048,344,93,125,51,61,161,1883,24,1907,2760,69.08499908
6401200-066,鳳山區新武里,828,264,76,95,39,46,138,1486,23,1509,2180,69.19500351
6401200-068,鳳山區新泰里,1237,498,147,169,64,96,242,2453,32,2485,3782,65.61000061
6401200-033,鳳山區新強里,1735,667,163,219,85,148,297,3314,40,3354,4966,67.59250069
6401200-036,鳳山區新富里,1457,533,98,180,73,95,270,2706,36,2742,3986,68.93666585
6401200-067,鳳山區新樂里,1367,570,172,231,65,122,197,2724,32,2756,4148,66.41666667
6401200-021,鳳山區新興里,512,195,64,56,19,33,111,990,17,1007,2408,48.10000038
6401200-018,鳳山區瑞竹里,1440,957,181,197,66,144,296,3281,59,3340,4764,70.08250046
6401200-031,鳳山區瑞興里,1234,879,209,169,96,174,257,3018,39,3057,4471,68.69666545
6401200-061,鳳山區誠信里,379,499,86,43,36,108,115,1266,16,1282,2001,64.21499825
6401200-062,鳳山區誠智里,632,523,117,116,39,136,134,1697,22,1719,2599,66.25500107
6401200-020,鳳山區誠義里,996,648,149,177,80,166,189,2405,15,2420,3430,70.56999969
6401200-050,鳳山區誠德里,544,495,96,70,22,84,140,1451,23,1474,2126,69.42000198
6401200-040,鳳山區過埤里,3685,1468,434,548,158,225,672,7190,82,7272,11221,64.89624977
6401200-077,鳳山區福祥里,1050,309,72,105,33,33,155,1757,29,1786,2606,68.53499985
6401200-049,鳳山區福誠里,1305,467,105,166,85,64,225,2417,43,2460,3586,68.75999959
6401200-029,鳳山區福興里,2238,724,169,224,71,101,307,3834,59,3893,5682,68.52999878
6401200-035,鳳山區鳳東里,1765,948,182,224,70,151,286,3626,45,3671,5525,66.52333323
6401200-007,鳳山區鳳崗里,312,213,48,48,26,38,62,747,7,754,1095,68.86000061
6401200-001,鳳山區縣口里,162,170,19,27,10,15,36,439,4,443,758,58.43999863
6401200-010,鳳山區縣衙里,222,163,26,25,13,28,54,531,9,540,829,65.13999939
6401200-004,鳳山區興中里,246,168,32,50,24,22,44,586,5,591,835,70.77999878
6401200-042,鳳山區興仁里,1130,562,124,154,64,98,208,2340,32,2372,3464,68.45000203
6401200-073,鳳山區龍成里,1073,352,75,109,44,32,157,1842,20,1862,2756,67.57500076
6401200-009,鳳山區鎮北里,2098,827,215,311,109,147,329,4036,61,4097,6379,64.43249989
6401200-012,鳳山區鎮西里,1650,757,169,235,80,146,299,3336,45,3381,4863,69.55500031
6401200-013,鳳山區鎮東里,719,345,89,79,36,66,147,1481,37,1518,2274,66.93499756
6401200-016,鳳山區鎮南里,1676,608,153,197,73,61,257,3025,61,3086,4513,68.66749954
6402000-017,橋頭區三德里,420,55,12,33,10,7,39,576,14,590,760,77.62999725
6402000-014,橋頭區中崎里,306,78,26,23,12,3,30,478,8,486,680,71.47000122
6402000-015,橋頭區仕和里,1626,462,131,188,62,44,213,2726,37,2763,3576,77.27000173
6402000-003,橋頭區仕隆里,967,294,65,121,38,42,172,1699,23,1722,2305,74.80999756
6402000-004,橋頭區仕豐里,886,355,70,106,33,57,128,1635,36,1671,2315,72.19000244
6402000-011,橋頭區甲北里,835,249,69,85,27,18,96,1379,31,1410,1937,72.46500015
6402000-012,橋頭區甲南里,976,299,57,122,31,24,145,1654,28,1682,2361,71.21500015
6402000-008,橋頭區白樹里,1178,440,101,120,42,56,151,2088,43,2131,3012,71.01999919
6402000-007,橋頭區西林里,688,169,43,65,24,15,92,1096,19,1115,1438,77.54500198
6402000-005,橋頭區芋寮里,590,146,38,48,9,8,69,908,30,938,1200,78.16999817
6402000-006,橋頭區東林里,1075,229,61,119,27,27,121,1659,33,1692,2309,73.22999954
6402000-013,橋頭區頂鹽里,549,155,47,47,10,30,63,901,25,926,1278,72.45999908
6402000-009,橋頭區筆秀里,707,171,52,53,18,21,62,1084,14,1098,1471,74.36999893
6402000-010,橋頭區新莊里,719,257,87,78,39,40,149,1369,32,1401,1892,75.11333466
6402000-016,橋頭區德松里,579,162,31,46,17,14,85,934,14,948,1265,74.94000244
6402000-002,橋頭區橋南里,455,154,30,47,22,27,48,783,9,792,1088,72.79000092
6402000-001,橋頭區橋頭里,750,261,69,117,24,38,130,1389,20,1409,1990,70.81000137
6402100-003,燕巢區安招里,1236,564,102,139,39,40,226,2346,78,2424,3316,70.80000114
6402100-001,燕巢區尖山里,445,119,32,25,7,3,128,759,24,783,1103,70.98999786
6402100-009,燕巢區西燕里,1147,465,139,107,52,28,222,2160,58,2218,3183,69.8799998
6402100-004,燕巢區角宿里,949,418,88,106,37,41,182,1821,43,1864,2534,73.30999756
6402100-007,燕巢區東燕里,876,308,64,78,31,18,164,1539,35,1574,2234,70.51000214
6402100-006,燕巢區金山里,156,78,23,10,5,7,29,308,19,327,462,70.77999878
6402100-008,燕巢區南燕里,1141,634,130,110,32,65,196,2308,64,2372,3504,67.78333282
6402100-011,燕巢區深水里,909,372,88,61,26,29,128,1613,41,1654,2485,66.375
6402100-005,燕巢區鳳雄里,886,386,81,70,33,27,114,1597,37,1634,2348,69.71999741
6402100-010,燕巢區橫山里,669,244,57,54,18,15,103,1160,27,1187,1827,65.4299984
6402100-002,燕巢區瓊林里,867,220,54,84,25,20,155,1425,38,1463,2013,72.75500107
6402800-007,彌陀區文安里,680,234,69,60,22,18,109,1192,43,1235,1680,73.43500137
6402800-001,彌陀區光和里,453,195,47,37,9,7,76,824,23,847,1216,69.65000153
6402800-012,彌陀區南寮里,709,298,104,58,13,29,137,1348,44,1392,2032,68.57000351
6402800-010,彌陀區海尾里,268,135,46,28,4,12,52,545,26,571,824,69.30000305
6402800-009,彌陀區過港里,334,135,52,32,7,12,47,619,36,655,884,74.09999847
6402800-011,彌陀區漯底里,385,232,35,30,22,12,59,775,27,802,1091,73.51000214
6402800-003,彌陀區彌仁里,182,105,27,22,5,1,36,378,8,386,550,70.18000031
6402800-005,彌陀區彌陀里,566,310,65,70,19,19,120,1169,35,1204,1665,72.28499985
6402800-002,彌陀區彌靖里,673,308,59,48,20,14,101,1223,39,1262,1758,71.78499985
6402800-004,彌陀區彌壽里,243,143,34,23,9,9,61,522,14,536,720,74.44000244
6402800-006,彌陀區舊港里,580,192,125,53,12,26,93,1081,32,1113,1564,71.18500137
6402800-008,彌陀區鹽埕里,738,312,81,71,25,15,125,1367,50,1417,1993,71.10000229
6400100-005,鹽埕區中山里,376,155,28,62,17,39,66,743,11,754,1061,71.06999969
6400100-008,鹽埕區中原里,231,99,21,34,11,9,37,442,7,449,605,74.20999908
6400100-009,鹽埕區光明里,445,205,42,51,20,48,65,876,13,889,1439,61.77999878
6400100-015,鹽埕區江西里,406,139,41,50,23,32,77,768,10,778,1086,71.63999939
6400100-021,鹽埕區江南里,291,52,12,23,11,7,32,428,9,437,623,70.13999939
6400100-012,鹽埕區沙地里,234,92,20,38,11,20,45,460,7,467,692,67.48999786
6400100-010,鹽埕區育仁里,279,114,26,40,15,22,33,529,9,538,760,70.79000092
6400100-017,鹽埕區府北里,651,290,53,66,19,51,88,1218,24,1242,1865,66.65500259
6400100-011,鹽埕區河濱里,537,254,57,89,37,58,107,1139,21,1160,1655,70.09000015
6400100-013,鹽埕區南端里,340,163,32,43,13,26,54,671,17,688,989,69.56999969
6400100-006,鹽埕區教仁里,778,343,64,80,51,65,106,1487,24,1511,2083,72.58499908
6400100-018,鹽埕區陸橋里,448,159,35,63,11,41,87,844,18,862,1240,69.51999664
6400100-003,鹽埕區博愛里,273,88,13,30,8,9,41,462,11,473,631,74.95999908
6400100-014,鹽埕區港都里,390,131,46,50,28,39,61,745,22,767,1078,71.15000153
6400100-002,鹽埕區慈愛里,118,51,3,9,3,4,23,211,6,217,322,67.38999939
6400100-020,鹽埕區新化里,231,90,16,21,14,20,37,429,12,441,585,75.37999725
6400100-007,鹽埕區新樂里,309,132,26,45,16,27,56,611,9,620,854,72.59999847
6400100-016,鹽埕區新豐里,261,103,41,23,12,28,52,520,6,526,781,67.34999847
6400100-004,鹽埕區壽星里,412,198,48,51,21,23,106,859,15,874,1308,66.81999969
6400100-001,鹽埕區藍橋里,516,157,49,59,21,29,78,909,11,920,1265,72.73000336
6400100-019,鹽埕區瀨南里,225,84,16,24,5,10,32,396,3,399,587,67.97000122